Empty_100_S111_R1_001.fastq.gz,9908,5420,4488,0.4530,45.30
Empty_100_S111_R2_001.fastq.gz,9908,6713,3195,0.3225,32.25
Empty_101_S112_R1_001.fastq.gz,15530,8015,7515,0.4839,48.39
Empty_101_S112_R2_001.fastq.gz,15530,10531,4999,0.3219,32.19
Empty_102_S115_R1_001.fastq.gz,59758,20093,39665,0.6638,66.38
Empty_102_S115_R2_001.fastq.gz,59758,29352,30406,0.5088,50.88
Empty_103_S120_R1_001.fastq.gz,200115,51387,148728,0.7432,74.32
Empty_103_S120_R2_001.fastq.gz,200115,87667,112448,0.5619,56.19
Empty_104_S124_R1_001.fastq.gz,70644,24045,46599,0.6596,65.96
Empty_104_S124_R2_001.fastq.gz,70644,38918,31726,0.4491,44.91
Empty_105_S126_R1_001.fastq.gz,95382,33710,61672,0.6466,64.66
Empty_105_S126_R2_001.fastq.gz,95382,50133,45249,0.4744,47.44
Empty_106_S127_R1_001.fastq.gz,206721,35127,171594,0.8301,83.01
Empty_106_S127_R2_001.fastq.gz,206721,67566,139155,0.6732,67.32
Empty_107_S128_R1_001.fastq.gz,244286,48534,195752,0.8013,80.13
Empty_107_S128_R2_001.fastq.gz,244286,99406,144880,0.5931,59.31
Empty_108_S130_R1_001.fastq.gz,32546,9324,23222,0.7135,71.35
Empty_108_S130_R2_001.fastq.gz,32546,17387,15159,0.4658,46.58
Empty_109_S131_R1_001.fastq.gz,14132,7143,6989,0.4946,49.46
Empty_109_S131_R2_001.fastq.gz,14132,9249,4883,0.3455,34.55
Empty_10_S10_R1_001.fastq.gz,2,2,0,0.0000,0.00
Empty_10_S10_R2_001.fastq.gz,2,2,0,0.0000,0.00
Empty_110_S141_R1_001.fastq.gz,11566,6302,5264,0.4551,45.51
Empty_110_S141_R2_001.fastq.gz,11566,7911,3655,0.3160,31.60
Empty_111_S143_R1_001.fastq.gz,189115,36583,152532,0.8066,80.66
Empty_111_S143_R2_001.fastq.gz,189115,68834,120281,0.6360,63.60
Empty_112_S147_R1_001.fastq.gz,120098,28928,91170,0.7591,75.91
Empty_112_S147_R2_001.fastq.gz,120098,48199,71899,0.5987,59.87
Empty_113_S150_R1_001.fastq.gz,88950,27384,61566,0.6921,69.21
Empty_113_S150_R2_001.fastq.gz,88950,43295,45655,0.5133,51.33
Empty_114_S152_R1_001.fastq.gz,189976,38452,151524,0.7976,79.76
Empty_114_S152_R2_001.fastq.gz,189976,88244,101732,0.5355,53.55
Empty_115_S153_R1_001.fastq.gz,97585,23913,73672,0.7550,75.50
Empty_115_S153_R2_001.fastq.gz,97585,40536,57049,0.5846,58.46
Empty_116_S155_R1_001.fastq.gz,151189,32961,118228,0.7820,78.20
Empty_116_S155_R2_001.fastq.gz,151189,54270,96919,0.6410,64.10
Empty_117_S161_R1_001.fastq.gz,175655,40283,135372,0.7707,77.07
Empty_117_S161_R2_001.fastq.gz,175655,70888,104767,0.5964,59.64
Empty_118_S164_R1_001.fastq.gz,14497,8663,5834,0.4024,40.24
Empty_118_S164_R2_001.fastq.gz,14497,10198,4299,0.2965,29.65
Empty_119_S166_R1_001.fastq.gz,192451,50928,141523,0.7354,73.54
Empty_119_S166_R2_001.fastq.gz,192451,91826,100625,0.5229,52.29
Empty_11_S11_R1_001.fastq.gz,2,2,0,0.0000,0.00
Empty_11_S11_R2_001.fastq.gz,2,2,0,0.0000,0.00
Empty_120_S167_R1_001.fastq.gz,267349,51355,215994,0.8079,80.79
Empty_120_S167_R2_001.fastq.gz,267349,104758,162591,0.6082,60.82
Empty_121_S171_R1_001.fastq.gz,14826,8248,6578,0.4437,44.37
Empty_121_S171_R2_001.fastq.gz,14826,9647,5179,0.3493,34.93
Empty_122_S172_R1_001.fastq.gz,116171,27008,89163,0.7675,76.75
Empty_122_S172_R2_001.fastq.gz,116171,49601,66570,0.5730,57.30
Empty_123_S174_R1_001.fastq.gz,272914,60199,212715,0.7794,77.94
Empty_123_S174_R2_001.fastq.gz,272914,101718,171196,0.6273,62.73
Empty_124_S175_R1_001.fastq.gz,161468,73903,87565,0.5423,54.23
Empty_124_S175_R2_001.fastq.gz,161468,60780,100688,0.6236,62.36
Empty_125_S177_R1_001.fastq.gz,75835,24364,51471,0.6787,67.87
Empty_125_S177_R2_001.fastq.gz,75835,33895,41940,0.5530,55.30
Empty_126_S182_R1_001.fastq.gz,138089,44448,93641,0.6781,67.81
Empty_126_S182_R2_001.fastq.gz,138089,62006,76083,0.5510,55.10
Empty_127_S190_R1_001.fastq.gz,65878,18351,47527,0.7214,72.14
Empty_127_S190_R2_001.fastq.gz,65878,31478,34400,0.5222,52.22
Empty_128_S191_R1_001.fastq.gz,128220,35495,92725,0.7232,72.32
Empty_128_S191_R2_001.fastq.gz,128220,53183,75037,0.5852,58.52
Empty_129_S193_R1_001.fastq.gz,280154,36895,243259,0.8683,86.83
Empty_129_S193_R2_001.fastq.gz,280154,93392,186762,0.6666,66.66
Empty_12_S12_R1_001.fastq.gz,1,1,0,0.0000,0.00
Empty_12_S12_R2_001.fastq.gz,1,1,0,0.0000,0.00
Empty_130_S199_R1_001.fastq.gz,296674,35070,261604,0.8818,88.18
Empty_130_S199_R2_001.fastq.gz,296674,98715,197959,0.6673,66.73
Empty_131_S207_R1_001.fastq.gz,238362,35044,203318,0.8530,85.30
Empty_131_S207_R2_001.fastq.gz,238362,85120,153242,0.6429,64.29
Empty_132_S208_R1_001.fastq.gz,18042,9229,8813,0.4885,48.85
Empty_132_S208_R2_001.fastq.gz,18042,12399,5643,0.3128,31.28
Empty_133_S220_R1_001.fastq.gz,126646,23008,103638,0.8183,81.83
Empty_133_S220_R2_001.fastq.gz,126646,88879,37767,0.2982,29.82
Empty_134_S221_R1_001.fastq.gz,158584,30241,128343,0.8093,80.93
Empty_134_S221_R2_001.fastq.gz,158584,65685,92899,0.5858,58.58
Empty_135_S226_R1_001.fastq.gz,197486,44435,153051,0.7750,77.50
Empty_135_S226_R2_001.fastq.gz,197486,91977,105509,0.5343,53.43
Empty_136_S231_R1_001.fastq.gz,256374,38763,217611,0.8488,84.88
Empty_136_S231_R2_001.fastq.gz,256374,96884,159490,0.6221,62.21
Empty_137_S233_R1_001.fastq.gz,244635,36008,208627,0.8528,85.28
Empty_137_S233_R2_001.fastq.gz,244635,75834,168801,0.6900,69.00
Empty_138_S237_R1_001.fastq.gz,11778,6588,5190,0.4407,44.07
Empty_138_S237_R2_001.fastq.gz,11778,8101,3677,0.3122,31.22
Empty_139_S243_R1_001.fastq.gz,13885,7679,6206,0.4470,44.70
Empty_139_S243_R2_001.fastq.gz,13885,9033,4852,0.3494,34.94
Empty_13_S13_R1_001.fastq.gz,2,2,0,0.0000,0.00
Empty_13_S13_R2_001.fastq.gz,2,2,0,0.0000,0.00
Empty_140_S246_R1_001.fastq.gz,270973,51570,219403,0.8097,80.97
Empty_140_S246_R2_001.fastq.gz,270973,117568,153405,0.5661,56.61
Empty_141_S248_R1_001.fastq.gz,329536,51634,277902,0.8433,84.33
Empty_141_S248_R2_001.fastq.gz,329536,121220,208316,0.6321,63.21
Empty_142_S266_R1_001.fastq.gz,238965,53574,185391,0.7758,77.58
Empty_142_S266_R2_001.fastq.gz,238965,111146,127819,0.5349,53.49
Empty_143_S267_R1_001.fastq.gz,13573,7147,6426,0.4734,47.34
Empty_143_S267_R2_001.fastq.gz,13573,8531,5042,0.3715,37.15
Empty_144_S271_R1_001.fastq.gz,467572,69688,397884,0.8510,85.10
Empty_144_S271_R2_001.fastq.gz,467572,140705,326867,0.6991,69.91
Empty_145_S278_R1_001.fastq.gz,13101,7192,5909,0.4510,45.10
Empty_145_S278_R2_001.fastq.gz,13101,9235,3866,0.2951,29.51
Empty_146_S289_R1_001.fastq.gz,15823,7909,7914,0.5002,50.02
Empty_146_S289_R2_001.fastq.gz,15823,10534,5289,0.3343,33.43
Empty_147_S302_R1_001.fastq.gz,465773,43576,422197,0.9064,90.64
Empty_147_S302_R2_001.fastq.gz,465773,94088,371685,0.7980,79.80
Empty_148_S303_R1_001.fastq.gz,15042,7360,7682,0.5107,51.07
Empty_148_S303_R2_001.fastq.gz,15042,9955,5087,0.3382,33.82
Empty_149_S304_R1_001.fastq.gz,23337,10850,12487,0.5351,53.51
Empty_149_S304_R2_001.fastq.gz,23337,15686,7651,0.3278,32.78
Empty_14_S14_R1_001.fastq.gz,1,1,0,0.0000,0.00
Empty_14_S14_R2_001.fastq.gz,1,1,0,0.0000,0.00
Empty_150_S316_R1_001.fastq.gz,460747,57643,403104,0.8749,87.49
Empty_150_S316_R2_001.fastq.gz,460747,110663,350084,0.7598,75.98
Empty_151_S317_R1_001.fastq.gz,321079,24092,296987,0.9250,92.50
Empty_151_S317_R2_001.fastq.gz,321079,53445,267634,0.8335,83.35
Empty_152a_S318_R1_001.fastq.gz,505252,64596,440656,0.8722,87.22
Empty_152a_S318_R2_001.fastq.gz,505252,124116,381136,0.7543,75.43
Empty_152b_S322_R1_001.fastq.gz,294651,29611,265040,0.8995,89.95
Empty_152b_S322_R2_001.fastq.gz,294651,70273,224378,0.7615,76.15
Empty_153_S327_R1_001.fastq.gz,380653,38688,341965,0.8984,89.84
Empty_153_S327_R2_001.fastq.gz,380653,84495,296158,0.7780,77.80
Empty_154_S329_R1_001.fastq.gz,287065,23048,264017,0.9197,91.97
Empty_154_S329_R2_001.fastq.gz,287065,52614,234451,0.8167,81.67
Empty_155_S333_R1_001.fastq.gz,10856,5833,5023,0.4627,46.27
Empty_155_S333_R2_001.fastq.gz,10856,7457,3399,0.3131,31.31
Empty_156_S342_R1_001.fastq.gz,347648,50635,297013,0.8543,85.43
Empty_156_S342_R2_001.fastq.gz,347648,95737,251911,0.7246,72.46
Empty_157_S344_R1_001.fastq.gz,366428,34162,332266,0.9068,90.68
Empty_157_S344_R2_001.fastq.gz,366428,83269,283159,0.7728,77.28
Empty_158_S345_R1_001.fastq.gz,337803,45208,292595,0.8662,86.62
Empty_158_S345_R2_001.fastq.gz,337803,94275,243528,0.7209,72.09
Empty_159_S347_R1_001.fastq.gz,444894,32366,412528,0.9273,92.73
Empty_159_S347_R2_001.fastq.gz,444894,70052,374842,0.8425,84.25
Empty_15_S15_R1_001.fastq.gz,1,1,0,0.0000,0.00
Empty_15_S15_R2_001.fastq.gz,1,1,0,0.0000,0.00
Empty_160_S353_R1_001.fastq.gz,337016,30230,306786,0.9103,91.03
Empty_160_S353_R2_001.fastq.gz,337016,66295,270721,0.8033,80.33
Empty_161_S362_R1_001.fastq.gz,339666,39351,300315,0.8841,88.41
Empty_161_S362_R2_001.fastq.gz,339666,82314,257352,0.7577,75.77
Empty_162_S363_R1_001.fastq.gz,12437,6262,6175,0.4965,49.65
Empty_162_S363_R2_001.fastq.gz,12437,8050,4387,0.3527,35.27
Empty_163_S364_R1_001.fastq.gz,377153,58418,318735,0.8451,84.51
Empty_163_S364_R2_001.fastq.gz,377153,108393,268760,0.7126,71.26
Empty_164_S367_R1_001.fastq.gz,469019,37048,431971,0.9210,92.10
Empty_164_S367_R2_001.fastq.gz,469019,100568,368451,0.7856,78.56
Empty_165_S374_R1_001.fastq.gz,328972,31469,297503,0.9043,90.43
Empty_165_S374_R2_001.fastq.gz,328972,67125,261847,0.7960,79.60
Empty_166_S385_R1_001.fastq.gz,3,3,0,0.0000,0.00
Empty_166_S385_R2_001.fastq.gz,3,3,0,0.0000,0.00
Empty_167_S386_R1_001.fastq.gz,3,3,0,0.0000,0.00
Empty_167_S386_R2_001.fastq.gz,3,3,0,0.0000,0.00
Empty_168_S387_R1_001.fastq.gz,0,0,0,0.0000,0.00
Empty_168_S387_R2_001.fastq.gz,0,0,0,0.0000,0.00
Empty_169_S388_R1_001.fastq.gz,0,0,0,0.0000,0.00
Empty_169_S388_R2_001.fastq.gz,0,0,0,0.0000,0.00
Empty_16_S16_R1_001.fastq.gz,3,3,0,0.0000,0.00
Empty_16_S16_R2_001.fastq.gz,3,3,0,0.0000,0.00
Empty_170_S389_R1_001.fastq.gz,0,0,0,0.0000,0.00
Empty_170_S389_R2_001.fastq.gz,0,0,0,0.0000,0.00
Empty_171_S390_R1_001.fastq.gz,2,2,0,0.0000,0.00
Empty_171_S390_R2_001.fastq.gz,2,2,0,0.0000,0.00
Empty_172_S391_R1_001.fastq.gz,0,0,0,0.0000,0.00
Empty_172_S391_R2_001.fastq.gz,0,0,0,0.0000,0.00
Empty_173_S392_R1_001.fastq.gz,1,1,0,0.0000,0.00
Empty_173_S392_R2_001.fastq.gz,1,1,0,0.0000,0.00
Empty_174_S393_R1_001.fastq.gz,25,25,0,0.0000,0.00
Empty_174_S393_R2_001.fastq.gz,25,25,0,0.0000,0.00
Empty_175_S394_R1_001.fastq.gz,9,9,0,0.0000,0.00
Empty_175_S394_R2_001.fastq.gz,9,9,0,0.0000,0.00
Empty_176_S395_R1_001.fastq.gz,1,1,0,0.0000,0.00
Empty_176_S395_R2_001.fastq.gz,1,1,0,0.0000,0.00
Empty_177_S396_R1_001.fastq.gz,12,12,0,0.0000,0.00
Empty_177_S396_R2_001.fastq.gz,12,12,0,0.0000,0.00
Empty_178_S397_R1_001.fastq.gz,34,34,0,0.0000,0.00
Empty_178_S397_R2_001.fastq.gz,34,34,0,0.0000,0.00
Empty_179_S398_R1_001.fastq.gz,26,26,0,0.0000,0.00
Empty_179_S398_R2_001.fastq.gz,26,26,0,0.0000,0.00
Empty_17_S17_R1_001.fastq.gz,2,2,0,0.0000,0.00
Empty_17_S17_R2_001.fastq.gz,2,2,0,0.0000,0.00
Empty_180_S399_R1_001.fastq.gz,11,11,0,0.0000,0.00
Empty_180_S399_R2_001.fastq.gz,11,11,0,0.0000,0.00
Empty_181_S400_R1_001.fastq.gz,19,19,0,0.0000,0.00
Empty_181_S400_R2_001.fastq.gz,19,19,0,0.0000,0.00
Empty_182_S401_R1_001.fastq.gz,0,0,0,0.0000,0.00
Empty_182_S401_R2_001.fastq.gz,0,0,0,0.0000,0.00
Empty_183_S402_R1_001.fastq.gz,0,0,0,0.0000,0.00
Empty_183_S402_R2_001.fastq.gz,0,0,0,0.0000,0.00
Empty_184_S403_R1_001.fastq.gz,0,0,0,0.0000,0.00
Empty_184_S403_R2_001.fastq.gz,0,0,0,0.0000,0.00
Empty_185_S404_R1_001.fastq.gz,1,1,0,0.0000,0.00
Empty_185_S404_R2_001.fastq.gz,1,1,0,0.0000,0.00
Empty_186_S405_R1_001.fastq.gz,0,0,0,0.0000,0.00
Empty_186_S405_R2_001.fastq.gz,0,0,0,0.0000,0.00
Empty_187_S406_R1_001.fastq.gz,0,0,0,0.0000,0.00
Empty_187_S406_R2_001.fastq.gz,0,0,0,0.0000,0.00
Empty_188_S407_R1_001.fastq.gz,1,1,0,0.0000,0.00
Empty_188_S407_R2_001.fastq.gz,1,1,0,0.0000,0.00
Empty_189_S408_R1_001.fastq.gz,6,5,1,0.1667,16.67
Empty_189_S408_R2_001.fastq.gz,6,6,0,0.0000,0.00
Empty_18_S18_R1_001.fastq.gz,4,3,1,0.2500,25.00
Empty_18_S18_R2_001.fastq.gz,4,4,0,0.0000,0.00
Empty_190_S409_R1_001.fastq.gz,0,0,0,0.0000,0.00
Empty_190_S409_R2_001.fastq.gz,0,0,0,0.0000,0.00
Empty_191_S410_R1_001.fastq.gz,0,0,0,0.0000,0.00
Empty_191_S410_R2_001.fastq.gz,0,0,0,0.0000,0.00
Empty_192_S411_R1_001.fastq.gz,0,0,0,0.0000,0.00
Empty_192_S411_R2_001.fastq.gz,0,0,0,0.0000,0.00
Empty_193_S412_R1_001.fastq.gz,0,0,0,0.0000,0.00
Empty_193_S412_R2_001.fastq.gz,0,0,0,0.0000,0.00
Empty_194_S413_R1_001.fastq.gz,2,2,0,0.0000,0.00
Empty_194_S413_R2_001.fastq.gz,2,2,0,0.0000,0.00
Empty_195_S414_R1_001.fastq.gz,1,1,0,0.0000,0.00
Empty_195_S414_R2_001.fastq.gz,1,1,0,0.0000,0.00
Empty_196_S415_R1_001.fastq.gz,0,0,0,0.0000,0.00
Empty_196_S415_R2_001.fastq.gz,0,0,0,0.0000,0.00
Empty_197_S416_R1_001.fastq.gz,0,0,0,0.0000,0.00
Empty_197_S416_R2_001.fastq.gz,0,0,0,0.0000,0.00
Empty_198_S417_R1_001.fastq.gz,0,0,0,0.0000,0.00
Empty_198_S417_R2_001.fastq.gz,0,0,0,0.0000,0.00
Empty_199_S418_R1_001.fastq.gz,0,0,0,0.0000,0.00
Empty_199_S418_R2_001.fastq.gz,0,0,0,0.0000,0.00
Empty_19_S19_R1_001.fastq.gz,0,0,0,0.0000,0.00
Empty_19_S19_R2_001.fastq.gz,0,0,0,0.0000,0.00
Empty_1_S1_R1_001.fastq.gz,1,1,0,0.0000,0.00
Empty_1_S1_R2_001.fastq.gz,1,1,0,0.0000,0.00
Empty_200_S419_R1_001.fastq.gz,0,0,0,0.0000,0.00
Empty_200_S419_R2_001.fastq.gz,0,0,0,0.0000,0.00
Empty_201_S420_R1_001.fastq.gz,0,0,0,0.0000,0.00
Empty_201_S420_R2_001.fastq.gz,0,0,0,0.0000,0.00
Empty_202_S421_R1_001.fastq.gz,0,0,0,0.0000,0.00
Empty_202_S421_R2_001.fastq.gz,0,0,0,0.0000,0.00
Empty_203_S422_R1_001.fastq.gz,2,2,0,0.0000,0.00
Empty_203_S422_R2_001.fastq.gz,2,2,0,0.0000,0.00
Empty_204_S423_R1_001.fastq.gz,1,1,0,0.0000,0.00
Empty_204_S423_R2_001.fastq.gz,1,1,0,0.0000,0.00
Empty_205_S424_R1_001.fastq.gz,3,3,0,0.0000,0.00
Empty_205_S424_R2_001.fastq.gz,3,3,0,0.0000,0.00
Empty_206_S425_R1_001.fastq.gz,3,3,0,0.0000,0.00
Empty_206_S425_R2_001.fastq.gz,3,3,0,0.0000,0.00
Empty_207_S426_R1_001.fastq.gz,1,1,0,0.0000,0.00
Empty_207_S426_R2_001.fastq.gz,1,1,0,0.0000,0.00
Empty_208_S427_R1_001.fastq.gz,2,2,0,0.0000,0.00
Empty_208_S427_R2_001.fastq.gz,2,2,0,0.0000,0.00
Empty_209_S428_R1_001.fastq.gz,10,9,1,0.1000,10.00
Empty_209_S428_R2_001.fastq.gz,10,10,0,0.0000,0.00
Empty_20_S20_R1_001.fastq.gz,0,0,0,0.0000,0.00
Empty_20_S20_R2_001.fastq.gz,0,0,0,0.0000,0.00
Empty_210_S429_R1_001.fastq.gz,8,8,0,0.0000,0.00
Empty_210_S429_R2_001.fastq.gz,8,8,0,0.0000,0.00
Empty_211_S430_R1_001.fastq.gz,6,6,0,0.0000,0.00
Empty_211_S430_R2_001.fastq.gz,6,6,0,0.0000,0.00
Empty_212_S431_R1_001.fastq.gz,1,1,0,0.0000,0.00
Empty_212_S431_R2_001.fastq.gz,1,1,0,0.0000,0.00
Empty_213_S432_R1_001.fastq.gz,10,10,0,0.0000,0.00
Empty_213_S432_R2_001.fastq.gz,10,10,0,0.0000,0.00
Empty_214_S433_R1_001.fastq.gz,13,10,3,0.2308,23.08
Empty_214_S433_R2_001.fastq.gz,13,10,3,0.2308,23.08
Empty_215_S434_R1_001.fastq.gz,7,3,4,0.5714,57.14
Empty_215_S434_R2_001.fastq.gz,7,7,0,0.0000,0.00
Empty_216_S435_R1_001.fastq.gz,10,7,3,0.3000,30.00
Empty_216_S435_R2_001.fastq.gz,10,10,0,0.0000,0.00
Empty_217_S436_R1_001.fastq.gz,1,1,0,0.0000,0.00
Empty_217_S436_R2_001.fastq.gz,1,1,0,0.0000,0.00
Empty_218_S437_R1_001.fastq.gz,11,9,2,0.1818,18.18
Empty_218_S437_R2_001.fastq.gz,11,10,1,0.0909,9.09
Empty_219_S438_R1_001.fastq.gz,6,4,2,0.3333,33.33
Empty_219_S438_R2_001.fastq.gz,6,3,3,0.5000,50.00
Empty_21_S21_R1_001.fastq.gz,0,0,0,0.0000,0.00
Empty_21_S21_R2_001.fastq.gz,0,0,0,0.0000,0.00
Empty_220_S439_R1_001.fastq.gz,10,6,4,0.4000,40.00
Empty_220_S439_R2_001.fastq.gz,10,7,3,0.3000,30.00
Empty_221_S440_R1_001.fastq.gz,4,2,2,0.5000,50.00
Empty_221_S440_R2_001.fastq.gz,4,3,1,0.2500,25.00
Empty_222_S441_R1_001.fastq.gz,0,0,0,0.0000,0.00
Empty_222_S441_R2_001.fastq.gz,0,0,0,0.0000,0.00
Empty_223_S442_R1_001.fastq.gz,0,0,0,0.0000,0.00
Empty_223_S442_R2_001.fastq.gz,0,0,0,0.0000,0.00
Empty_224_S443_R1_001.fastq.gz,0,0,0,0.0000,0.00
Empty_224_S443_R2_001.fastq.gz,0,0,0,0.0000,0.00
Empty_225_S444_R1_001.fastq.gz,0,0,0,0.0000,0.00
Empty_225_S444_R2_001.fastq.gz,0,0,0,0.0000,0.00
Empty_226_S445_R1_001.fastq.gz,0,0,0,0.0000,0.00
Empty_226_S445_R2_001.fastq.gz,0,0,0,0.0000,0.00
Empty_227_S446_R1_001.fastq.gz,0,0,0,0.0000,0.00
Empty_227_S446_R2_001.fastq.gz,0,0,0,0.0000,0.00
Empty_228_S447_R1_001.fastq.gz,0,0,0,0.0000,0.00
Empty_228_S447_R2_001.fastq.gz,0,0,0,0.0000,0.00
Empty_229_S448_R1_001.fastq.gz,0,0,0,0.0000,0.00
Empty_229_S448_R2_001.fastq.gz,0,0,0,0.0000,0.00
Empty_22_S22_R1_001.fastq.gz,0,0,0,0.0000,0.00
Empty_22_S22_R2_001.fastq.gz,0,0,0,0.0000,0.00
Empty_230_S449_R1_001.fastq.gz,22,22,0,0.0000,0.00
Empty_230_S449_R2_001.fastq.gz,22,22,0,0.0000,0.00
Empty_231_S450_R1_001.fastq.gz,2,2,0,0.0000,0.00
Empty_231_S450_R2_001.fastq.gz,2,2,0,0.0000,0.00
Empty_232_S451_R1_001.fastq.gz,27,26,1,0.0370,3.70
Empty_232_S451_R2_001.fastq.gz,27,27,0,0.0000,0.00
Empty_233_S452_R1_001.fastq.gz,25,25,0,0.0000,0.00
Empty_233_S452_R2_001.fastq.gz,25,25,0,0.0000,0.00
Empty_234_S453_R1_001.fastq.gz,27,27,0,0.0000,0.00
Empty_234_S453_R2_001.fastq.gz,27,27,0,0.0000,0.00
Empty_235_S454_R1_001.fastq.gz,43,43,0,0.0000,0.00
Empty_235_S454_R2_001.fastq.gz,43,43,0,0.0000,0.00
Empty_236_S455_R1_001.fastq.gz,40,39,1,0.0250,2.50
Empty_236_S455_R2_001.fastq.gz,40,40,0,0.0000,0.00
Empty_237_S456_R1_001.fastq.gz,41,40,1,0.0244,2.44
Empty_237_S456_R2_001.fastq.gz,41,41,0,0.0000,0.00
Empty_238_S457_R1_001.fastq.gz,7,6,1,0.1429,14.29
Empty_238_S457_R2_001.fastq.gz,7,6,1,0.1429,14.29
Empty_239_S458_R1_001.fastq.gz,1,1,0,0.0000,0.00
Empty_239_S458_R2_001.fastq.gz,1,1,0,0.0000,0.00
Empty_23_S23_R1_001.fastq.gz,0,0,0,0.0000,0.00
Empty_23_S23_R2_001.fastq.gz,0,0,0,0.0000,0.00
Empty_240_S459_R1_001.fastq.gz,1,1,0,0.0000,0.00
Empty_240_S459_R2_001.fastq.gz,1,1,0,0.0000,0.00
Empty_241_S460_R1_001.fastq.gz,2,2,0,0.0000,0.00
Empty_241_S460_R2_001.fastq.gz,2,2,0,0.0000,0.00
Empty_242_S461_R1_001.fastq.gz,1,1,0,0.0000,0.00
Empty_242_S461_R2_001.fastq.gz,1,1,0,0.0000,0.00
Empty_243_S462_R1_001.fastq.gz,0,0,0,0.0000,0.00
Empty_243_S462_R2_001.fastq.gz,0,0,0,0.0000,0.00
Empty_244_S463_R1_001.fastq.gz,1,1,0,0.0000,0.00
Empty_244_S463_R2_001.fastq.gz,1,1,0,0.0000,0.00
Empty_245_S464_R1_001.fastq.gz,4,3,1,0.2500,25.00
Empty_245_S464_R2_001.fastq.gz,4,4,0,0.0000,0.00
Empty_246_S465_R1_001.fastq.gz,1,1,0,0.0000,0.00
Empty_246_S465_R2_001.fastq.gz,1,1,0,0.0000,0.00
Empty_247_S466_R1_001.fastq.gz,1,1,0,0.0000,0.00
Empty_247_S466_R2_001.fastq.gz,1,1,0,0.0000,0.00
Empty_248_S467_R1_001.fastq.gz,1,1,0,0.0000,0.00
Empty_248_S467_R2_001.fastq.gz,1,1,0,0.0000,0.00
Empty_249_S468_R1_001.fastq.gz,0,0,0,0.0000,0.00
Empty_249_S468_R2_001.fastq.gz,0,0,0,0.0000,0.00
Empty_24_S24_R1_001.fastq.gz,1,1,0,0.0000,0.00
Empty_24_S24_R2_001.fastq.gz,1,1,0,0.0000,0.00
Empty_250_S469_R1_001.fastq.gz,3,2,1,0.3333,33.33
Empty_250_S469_R2_001.fastq.gz,3,3,0,0.0000,0.00
Empty_251_S470_R1_001.fastq.gz,2,2,0,0.0000,0.00
Empty_251_S470_R2_001.fastq.gz,2,2,0,0.0000,0.00
Empty_252_S471_R1_001.fastq.gz,0,0,0,0.0000,0.00
Empty_252_S471_R2_001.fastq.gz,0,0,0,0.0000,0.00
Empty_253_S472_R1_001.fastq.gz,9,8,1,0.1111,11.11
Empty_253_S472_R2_001.fastq.gz,9,8,1,0.1111,11.11
Empty_254_S473_R1_001.fastq.gz,3,3,0,0.0000,0.00
Empty_254_S473_R2_001.fastq.gz,3,3,0,0.0000,0.00
Empty_255_S474_R1_001.fastq.gz,0,0,0,0.0000,0.00
Empty_255_S474_R2_001.fastq.gz,0,0,0,0.0000,0.00
Empty_256_S475_R1_001.fastq.gz,4,4,0,0.0000,0.00
Empty_256_S475_R2_001.fastq.gz,4,4,0,0.0000,0.00
Empty_257_S476_R1_001.fastq.gz,4,4,0,0.0000,0.00
Empty_257_S476_R2_001.fastq.gz,4,4,0,0.0000,0.00
Empty_258_S477_R1_001.fastq.gz,3,3,0,0.0000,0.00
Empty_258_S477_R2_001.fastq.gz,3,3,0,0.0000,0.00
Empty_259_S478_R1_001.fastq.gz,3,2,1,0.3333,33.33
Empty_259_S478_R2_001.fastq.gz,3,3,0,0.0000,0.00
Empty_25_S25_R1_001.fastq.gz,0,0,0,0.0000,0.00
Empty_25_S25_R2_001.fastq.gz,0,0,0,0.0000,0.00
Empty_260_S479_R1_001.fastq.gz,0,0,0,0.0000,0.00
Empty_260_S479_R2_001.fastq.gz,0,0,0,0.0000,0.00
Empty_261_S480_R1_001.fastq.gz,9,8,1,0.1111,11.11
Empty_261_S480_R2_001.fastq.gz,9,9,0,0.0000,0.00
Empty_262_S481_R1_001.fastq.gz,17781,10038,7743,0.4355,43.55
Empty_262_S481_R2_001.fastq.gz,17781,13112,4669,0.2626,26.26
Empty_263_S486_R1_001.fastq.gz,327901,55639,272262,0.8303,83.03
Empty_263_S486_R2_001.fastq.gz,327901,122234,205667,0.6272,62.72
Empty_264_S487_R1_001.fastq.gz,316448,70748,245700,0.7764,77.64
Empty_264_S487_R2_001.fastq.gz,316448,140647,175801,0.5555,55.55
Empty_265_S490_R1_001.fastq.gz,5755,3487,2268,0.3941,39.41
Empty_265_S490_R2_001.fastq.gz,5755,4646,1109,0.1927,19.27
Empty_266_S494_R1_001.fastq.gz,393907,93292,300615,0.7632,76.32
Empty_266_S494_R2_001.fastq.gz,393907,202581,191326,0.4857,48.57
Empty_267_S495_R1_001.fastq.gz,11352,6808,4544,0.4003,40.03
Empty_267_S495_R2_001.fastq.gz,11352,8642,2710,0.2387,23.87
Empty_268_S496_R1_001.fastq.gz,17280,10062,7218,0.4177,41.77
Empty_268_S496_R2_001.fastq.gz,17280,12997,4283,0.2479,24.79
Empty_269_S499_R1_001.fastq.gz,244325,58604,185721,0.7601,76.01
Empty_269_S499_R2_001.fastq.gz,244325,111407,132918,0.5440,54.40
Empty_26_S26_R1_001.fastq.gz,0,0,0,0.0000,0.00
Empty_26_S26_R2_001.fastq.gz,0,0,0,0.0000,0.00
Empty_270_S506_R1_001.fastq.gz,8444,4775,3669,0.4345,43.45
Empty_270_S506_R2_001.fastq.gz,8444,6465,1979,0.2344,23.44
Empty_271_S508_R1_001.fastq.gz,393122,81308,311814,0.7932,79.32
Empty_271_S508_R2_001.fastq.gz,393122,169082,224040,0.5699,56.99
Empty_272_S509_R1_001.fastq.gz,367915,67286,300629,0.8171,81.71
Empty_272_S509_R2_001.fastq.gz,367915,143074,224841,0.6111,61.11
Empty_273_S510_R1_001.fastq.gz,339905,69395,270510,0.7958,79.58
Empty_273_S510_R2_001.fastq.gz,339905,141084,198821,0.5849,58.49
Empty_274_S512_R1_001.fastq.gz,540852,54778,486074,0.8987,89.87
Empty_274_S512_R2_001.fastq.gz,540852,133463,407389,0.7532,75.32
Empty_275_S514_R1_001.fastq.gz,270600,25338,245262,0.9064,90.64
Empty_275_S514_R2_001.fastq.gz,270600,68773,201827,0.7458,74.58
Empty_276_S519_R1_001.fastq.gz,288231,40671,247560,0.8589,85.89
Empty_276_S519_R2_001.fastq.gz,288231,89451,198780,0.6897,68.97
Empty_277_S521_R1_001.fastq.gz,15675,8709,6966,0.4444,44.44
Empty_277_S521_R2_001.fastq.gz,15675,11678,3997,0.2550,25.50
Empty_278_S525_R1_001.fastq.gz,17338,9881,7457,0.4301,43.01
Empty_278_S525_R2_001.fastq.gz,17338,12960,4378,0.2525,25.25
Empty_279_S531_R1_001.fastq.gz,274322,31413,242909,0.8855,88.55
Empty_279_S531_R2_001.fastq.gz,274322,76219,198103,0.7222,72.22
Empty_27_S27_R1_001.fastq.gz,0,0,0,0.0000,0.00
Empty_27_S27_R2_001.fastq.gz,0,0,0,0.0000,0.00
Empty_280_S534_R1_001.fastq.gz,252826,68774,184052,0.7280,72.80
Empty_280_S534_R2_001.fastq.gz,252826,123262,129564,0.5125,51.25
Empty_281_S536_R1_001.fastq.gz,508680,36967,471713,0.9273,92.73
Empty_281_S536_R2_001.fastq.gz,508680,95930,412750,0.8114,81.14
Empty_282_S537_R1_001.fastq.gz,268458,47019,221439,0.8249,82.49
Empty_282_S537_R2_001.fastq.gz,268458,98861,169597,0.6317,63.17
Empty_283_S539_R1_001.fastq.gz,12196,7269,4927,0.4040,40.40
Empty_283_S539_R2_001.fastq.gz,12196,9273,2923,0.2397,23.97
Empty_284_S545_R1_001.fastq.gz,323698,33324,290374,0.8971,89.71
Empty_284_S545_R2_001.fastq.gz,323698,82702,240996,0.7445,74.45
Empty_285_S548_R1_001.fastq.gz,19611,11460,8151,0.4156,41.56
Empty_285_S548_R2_001.fastq.gz,19611,14630,4981,0.2540,25.40
Empty_286_S550_R1_001.fastq.gz,216817,42032,174785,0.8061,80.61
Empty_286_S550_R2_001.fastq.gz,216817,93756,123061,0.5676,56.76
Empty_287_S554_R1_001.fastq.gz,237972,45013,192959,0.8108,81.08
Empty_287_S554_R2_001.fastq.gz,237972,91488,146484,0.6156,61.56
Empty_288_S555_R1_001.fastq.gz,15007,9041,5966,0.3975,39.75
Empty_288_S555_R2_001.fastq.gz,15007,11216,3791,0.2526,25.26
Empty_289_S556_R1_001.fastq.gz,256540,67566,188974,0.7366,73.66
Empty_289_S556_R2_001.fastq.gz,256540,126198,130342,0.5081,50.81
Empty_28_S28_R1_001.fastq.gz,0,0,0,0.0000,0.00
Empty_28_S28_R2_001.fastq.gz,0,0,0,0.0000,0.00
Empty_290_S558_R1_001.fastq.gz,15845,9492,6353,0.4009,40.09
Empty_290_S558_R2_001.fastq.gz,15845,11914,3931,0.2481,24.81
Empty_291_S559_R1_001.fastq.gz,318231,48105,270126,0.8488,84.88
Empty_291_S559_R2_001.fastq.gz,318231,110110,208121,0.6540,65.40
Empty_292_S561_R1_001.fastq.gz,231825,51722,180103,0.7769,77.69
Empty_292_S561_R2_001.fastq.gz,231825,101641,130184,0.5616,56.16
Empty_293_S566_R1_001.fastq.gz,332705,44031,288674,0.8677,86.77
Empty_293_S566_R2_001.fastq.gz,332705,104931,227774,0.6846,68.46
Empty_294_S574_R1_001.fastq.gz,258410,24299,234111,0.9060,90.60
Empty_294_S574_R2_001.fastq.gz,258410,59685,198725,0.7690,76.90
Empty_295_S584_R1_001.fastq.gz,572705,110360,462345,0.8073,80.73
Empty_295_S584_R2_001.fastq.gz,572705,183645,389060,0.6793,67.93
Empty_296_S592_R1_001.fastq.gz,386782,102650,284132,0.7346,73.46
Empty_296_S592_R2_001.fastq.gz,386782,151994,234788,0.6070,60.70
Empty_297_S603_R1_001.fastq.gz,395926,110376,285550,0.7212,72.12
Empty_297_S603_R2_001.fastq.gz,395926,167003,228923,0.5782,57.82
Empty_298_S632_R1_001.fastq.gz,456277,109433,346844,0.7602,76.02
Empty_298_S632_R2_001.fastq.gz,456277,204902,251375,0.5509,55.09
Empty_299_S638_R1_001.fastq.gz,557234,103478,453756,0.8143,81.43
Empty_299_S638_R2_001.fastq.gz,557234,183425,373809,0.6708,67.08
Empty_29_S29_R1_001.fastq.gz,2,1,1,0.5000,50.00
Empty_29_S29_R2_001.fastq.gz,2,1,1,0.5000,50.00
Empty_2_S2_R1_001.fastq.gz,0,0,0,0.0000,0.00
Empty_2_S2_R2_001.fastq.gz,0,0,0,0.0000,0.00
Empty_300_S643_R1_001.fastq.gz,255942,93668,162274,0.6340,63.40
Empty_300_S643_R2_001.fastq.gz,255942,124953,130989,0.5118,51.18
Empty_301_S644_R1_001.fastq.gz,242416,36375,206041,0.8499,84.99
Empty_301_S644_R2_001.fastq.gz,242416,81682,160734,0.6631,66.31
Empty_302_S650_R1_001.fastq.gz,8186,4731,3455,0.4221,42.21
Empty_302_S650_R2_001.fastq.gz,8186,6123,2063,0.2520,25.20
Empty_303_S651_R1_001.fastq.gz,311893,59388,252505,0.8096,80.96
Empty_303_S651_R2_001.fastq.gz,311893,115115,196778,0.6309,63.09
Empty_304_S653_R1_001.fastq.gz,318217,123806,194411,0.6109,61.09
Empty_304_S653_R2_001.fastq.gz,318217,169191,149026,0.4683,46.83
Empty_305_S656_R1_001.fastq.gz,25413,14233,11180,0.4399,43.99
Empty_305_S656_R2_001.fastq.gz,25413,18110,7303,0.2874,28.74
Empty_306_S680_R1_001.fastq.gz,496160,155564,340596,0.6865,68.65
Empty_306_S680_R2_001.fastq.gz,496160,251185,244975,0.4937,49.37
Empty_307_S690_R1_001.fastq.gz,286987,27157,259830,0.9054,90.54
Empty_307_S690_R2_001.fastq.gz,286987,105116,181871,0.6337,63.37
Empty_308_S734_R1_001.fastq.gz,11034,6662,4372,0.3962,39.62
Empty_308_S734_R2_001.fastq.gz,11034,8418,2616,0.2371,23.71
Empty_309_S746_R1_001.fastq.gz,241543,21539,220004,0.9108,91.08
Empty_309_S746_R2_001.fastq.gz,241543,84642,156901,0.6496,64.96
Empty_30_S30_R1_001.fastq.gz,1,1,0,0.0000,0.00
Empty_30_S30_R2_001.fastq.gz,1,1,0,0.0000,0.00
Empty_310_S747_R1_001.fastq.gz,294598,42767,251831,0.8548,85.48
Empty_310_S747_R2_001.fastq.gz,294598,102578,192020,0.6518,65.18
Empty_311_S752_R1_001.fastq.gz,449090,90275,358815,0.7990,79.90
Empty_311_S752_R2_001.fastq.gz,449090,183305,265785,0.5918,59.18
Empty_312_S756_R1_001.fastq.gz,237992,33648,204344,0.8586,85.86
Empty_312_S756_R2_001.fastq.gz,237992,89881,148111,0.6223,62.23
Empty_313_S766_R1_001.fastq.gz,278665,39791,238874,0.8572,85.72
Empty_313_S766_R2_001.fastq.gz,278665,96370,182295,0.6542,65.42
Empty_314_S769_R1_001.fastq.gz,0,0,0,0.0000,0.00
Empty_314_S769_R2_001.fastq.gz,0,0,0,0.0000,0.00
Empty_315_S770_R1_001.fastq.gz,2,2,0,0.0000,0.00
Empty_315_S770_R2_001.fastq.gz,2,2,0,0.0000,0.00
Empty_316_S771_R1_001.fastq.gz,0,0,0,0.0000,0.00
Empty_316_S771_R2_001.fastq.gz,0,0,0,0.0000,0.00
Empty_317_S772_R1_001.fastq.gz,0,0,0,0.0000,0.00
Empty_317_S772_R2_001.fastq.gz,0,0,0,0.0000,0.00
Empty_318_S773_R1_001.fastq.gz,0,0,0,0.0000,0.00
Empty_318_S773_R2_001.fastq.gz,0,0,0,0.0000,0.00
Empty_319_S774_R1_001.fastq.gz,0,0,0,0.0000,0.00
Empty_319_S774_R2_001.fastq.gz,0,0,0,0.0000,0.00
Empty_31_S31_R1_001.fastq.gz,0,0,0,0.0000,0.00
Empty_31_S31_R2_001.fastq.gz,0,0,0,0.0000,0.00
Empty_320_S775_R1_001.fastq.gz,3,3,0,0.0000,0.00
Empty_320_S775_R2_001.fastq.gz,3,3,0,0.0000,0.00
Empty_321_S776_R1_001.fastq.gz,3,1,2,0.6667,66.67
Empty_321_S776_R2_001.fastq.gz,3,2,1,0.3333,33.33
Empty_322_S777_R1_001.fastq.gz,5,5,0,0.0000,0.00
Empty_322_S777_R2_001.fastq.gz,5,4,1,0.2000,20.00
Empty_323_S778_R1_001.fastq.gz,3,3,0,0.0000,0.00
Empty_323_S778_R2_001.fastq.gz,3,3,0,0.0000,0.00
Empty_324_S779_R1_001.fastq.gz,4,4,0,0.0000,0.00
Empty_324_S779_R2_001.fastq.gz,4,4,0,0.0000,0.00
Empty_325_S780_R1_001.fastq.gz,6,5,1,0.1667,16.67
Empty_325_S780_R2_001.fastq.gz,6,6,0,0.0000,0.00
Empty_326_S781_R1_001.fastq.gz,16,15,1,0.0625,6.25
Empty_326_S781_R2_001.fastq.gz,16,15,1,0.0625,6.25
Empty_327_S782_R1_001.fastq.gz,1,1,0,0.0000,0.00
Empty_327_S782_R2_001.fastq.gz,1,1,0,0.0000,0.00
Empty_328_S783_R1_001.fastq.gz,4,4,0,0.0000,0.00
Empty_328_S783_R2_001.fastq.gz,4,4,0,0.0000,0.00
Empty_329_S784_R1_001.fastq.gz,11,11,0,0.0000,0.00
Empty_329_S784_R2_001.fastq.gz,11,10,1,0.0909,9.09
Empty_32_S32_R1_001.fastq.gz,1,1,0,0.0000,0.00
Empty_32_S32_R2_001.fastq.gz,1,1,0,0.0000,0.00
Empty_330_S785_R1_001.fastq.gz,0,0,0,0.0000,0.00
Empty_330_S785_R2_001.fastq.gz,0,0,0,0.0000,0.00
Empty_331_S786_R1_001.fastq.gz,0,0,0,0.0000,0.00
Empty_331_S786_R2_001.fastq.gz,0,0,0,0.0000,0.00
Empty_332_S787_R1_001.fastq.gz,1,1,0,0.0000,0.00
Empty_332_S787_R2_001.fastq.gz,1,1,0,0.0000,0.00
Empty_333_S788_R1_001.fastq.gz,1,1,0,0.0000,0.00
Empty_333_S788_R2_001.fastq.gz,1,1,0,0.0000,0.00
Empty_334_S789_R1_001.fastq.gz,0,0,0,0.0000,0.00
Empty_334_S789_R2_001.fastq.gz,0,0,0,0.0000,0.00
Empty_335_S790_R1_001.fastq.gz,0,0,0,0.0000,0.00
Empty_335_S790_R2_001.fastq.gz,0,0,0,0.0000,0.00
Empty_336_S791_R1_001.fastq.gz,0,0,0,0.0000,0.00
Empty_336_S791_R2_001.fastq.gz,0,0,0,0.0000,0.00
Empty_337_S792_R1_001.fastq.gz,0,0,0,0.0000,0.00
Empty_337_S792_R2_001.fastq.gz,0,0,0,0.0000,0.00
Empty_338_S793_R1_001.fastq.gz,0,0,0,0.0000,0.00
Empty_338_S793_R2_001.fastq.gz,0,0,0,0.0000,0.00
Empty_339_S794_R1_001.fastq.gz,0,0,0,0.0000,0.00
Empty_339_S794_R2_001.fastq.gz,0,0,0,0.0000,0.00
Empty_33_S33_R1_001.fastq.gz,0,0,0,0.0000,0.00
Empty_33_S33_R2_001.fastq.gz,0,0,0,0.0000,0.00
Empty_340_S795_R1_001.fastq.gz,0,0,0,0.0000,0.00
Empty_340_S795_R2_001.fastq.gz,0,0,0,0.0000,0.00
Empty_341_S796_R1_001.fastq.gz,0,0,0,0.0000,0.00
Empty_341_S796_R2_001.fastq.gz,0,0,0,0.0000,0.00
Empty_342_S797_R1_001.fastq.gz,0,0,0,0.0000,0.00
Empty_342_S797_R2_001.fastq.gz,0,0,0,0.0000,0.00
Empty_343_S798_R1_001.fastq.gz,0,0,0,0.0000,0.00
Empty_343_S798_R2_001.fastq.gz,0,0,0,0.0000,0.00
Empty_344_S799_R1_001.fastq.gz,0,0,0,0.0000,0.00
Empty_344_S799_R2_001.fastq.gz,0,0,0,0.0000,0.00
Empty_345_S800_R1_001.fastq.gz,1,1,0,0.0000,0.00
Empty_345_S800_R2_001.fastq.gz,1,1,0,0.0000,0.00
Empty_346_S801_R1_001.fastq.gz,0,0,0,0.0000,0.00
Empty_346_S801_R2_001.fastq.gz,0,0,0,0.0000,0.00
Empty_347_S802_R1_001.fastq.gz,1,1,0,0.0000,0.00
Empty_347_S802_R2_001.fastq.gz,1,1,0,0.0000,0.00
Empty_348_S803_R1_001.fastq.gz,0,0,0,0.0000,0.00
Empty_348_S803_R2_001.fastq.gz,0,0,0,0.0000,0.00
Empty_349_S804_R1_001.fastq.gz,0,0,0,0.0000,0.00
Empty_349_S804_R2_001.fastq.gz,0,0,0,0.0000,0.00
Empty_34_S34_R1_001.fastq.gz,0,0,0,0.0000,0.00
Empty_34_S34_R2_001.fastq.gz,0,0,0,0.0000,0.00
Empty_350_S805_R1_001.fastq.gz,0,0,0,0.0000,0.00
Empty_350_S805_R2_001.fastq.gz,0,0,0,0.0000,0.00
Empty_351_S806_R1_001.fastq.gz,1,1,0,0.0000,0.00
Empty_351_S806_R2_001.fastq.gz,1,1,0,0.0000,0.00
Empty_352_S807_R1_001.fastq.gz,0,0,0,0.0000,0.00
Empty_352_S807_R2_001.fastq.gz,0,0,0,0.0000,0.00
Empty_353_S808_R1_001.fastq.gz,0,0,0,0.0000,0.00
Empty_353_S808_R2_001.fastq.gz,0,0,0,0.0000,0.00
Empty_354_S809_R1_001.fastq.gz,8,4,4,0.5000,50.00
Empty_354_S809_R2_001.fastq.gz,8,6,2,0.2500,25.00
Empty_355_S810_R1_001.fastq.gz,9,6,3,0.3333,33.33
Empty_355_S810_R2_001.fastq.gz,9,9,0,0.0000,0.00
Empty_356_S811_R1_001.fastq.gz,6,5,1,0.1667,16.67
Empty_356_S811_R2_001.fastq.gz,6,6,0,0.0000,0.00
Empty_357_S812_R1_001.fastq.gz,9,9,0,0.0000,0.00
Empty_357_S812_R2_001.fastq.gz,9,9,0,0.0000,0.00
Empty_358_S813_R1_001.fastq.gz,14,13,1,0.0714,7.14
Empty_358_S813_R2_001.fastq.gz,14,13,1,0.0714,7.14
Empty_359_S814_R1_001.fastq.gz,7,5,2,0.2857,28.57
Empty_359_S814_R2_001.fastq.gz,7,7,0,0.0000,0.00
Empty_35_S35_R1_001.fastq.gz,1,1,0,0.0000,0.00
Empty_35_S35_R2_001.fastq.gz,1,1,0,0.0000,0.00
Empty_360_S815_R1_001.fastq.gz,5,5,0,0.0000,0.00
Empty_360_S815_R2_001.fastq.gz,5,5,0,0.0000,0.00
Empty_361_S816_R1_001.fastq.gz,9,9,0,0.0000,0.00
Empty_361_S816_R2_001.fastq.gz,9,9,0,0.0000,0.00
Empty_362_S817_R1_001.fastq.gz,3,2,1,0.3333,33.33
Empty_362_S817_R2_001.fastq.gz,3,2,1,0.3333,33.33
Empty_363_S818_R1_001.fastq.gz,8,5,3,0.3750,37.50
Empty_363_S818_R2_001.fastq.gz,8,4,4,0.5000,50.00
Empty_364_S819_R1_001.fastq.gz,10,5,5,0.5000,50.00
Empty_364_S819_R2_001.fastq.gz,10,7,3,0.3000,30.00
Empty_365_S820_R1_001.fastq.gz,2,1,1,0.5000,50.00
Empty_365_S820_R2_001.fastq.gz,2,2,0,0.0000,0.00
Empty_366_S821_R1_001.fastq.gz,9,7,2,0.2222,22.22
Empty_366_S821_R2_001.fastq.gz,9,9,0,0.0000,0.00
Empty_367_S822_R1_001.fastq.gz,13,5,8,0.6154,61.54
Empty_367_S822_R2_001.fastq.gz,13,11,2,0.1538,15.38
Empty_368_S823_R1_001.fastq.gz,3,2,1,0.3333,33.33
Empty_368_S823_R2_001.fastq.gz,3,3,0,0.0000,0.00
Empty_369_S824_R1_001.fastq.gz,6,3,3,0.5000,50.00
Empty_369_S824_R2_001.fastq.gz,6,4,2,0.3333,33.33
Empty_36_S36_R1_001.fastq.gz,0,0,0,0.0000,0.00
Empty_36_S36_R2_001.fastq.gz,0,0,0,0.0000,0.00
Empty_370_S825_R1_001.fastq.gz,3,2,1,0.3333,33.33
Empty_370_S825_R2_001.fastq.gz,3,3,0,0.0000,0.00
Empty_371_S826_R1_001.fastq.gz,0,0,0,0.0000,0.00
Empty_371_S826_R2_001.fastq.gz,0,0,0,0.0000,0.00
Empty_372_S827_R1_001.fastq.gz,1,1,0,0.0000,0.00
Empty_372_S827_R2_001.fastq.gz,1,1,0,0.0000,0.00
Empty_373_S828_R1_001.fastq.gz,0,0,0,0.0000,0.00
Empty_373_S828_R2_001.fastq.gz,0,0,0,0.0000,0.00
Empty_374_S829_R1_001.fastq.gz,0,0,0,0.0000,0.00
Empty_374_S829_R2_001.fastq.gz,0,0,0,0.0000,0.00
Empty_375_S830_R1_001.fastq.gz,3,3,0,0.0000,0.00
Empty_375_S830_R2_001.fastq.gz,3,3,0,0.0000,0.00
Empty_376_S831_R1_001.fastq.gz,2,1,1,0.5000,50.00
Empty_376_S831_R2_001.fastq.gz,2,1,1,0.5000,50.00
Empty_377_S832_R1_001.fastq.gz,0,0,0,0.0000,0.00
Empty_377_S832_R2_001.fastq.gz,0,0,0,0.0000,0.00
Empty_378_S833_R1_001.fastq.gz,32,31,1,0.0312,3.12
Empty_378_S833_R2_001.fastq.gz,32,32,0,0.0000,0.00
Empty_379_S834_R1_001.fastq.gz,34,32,2,0.0588,5.88
Empty_379_S834_R2_001.fastq.gz,34,33,1,0.0294,2.94
Empty_37_S37_R1_001.fastq.gz,0,0,0,0.0000,0.00
Empty_37_S37_R2_001.fastq.gz,0,0,0,0.0000,0.00
Empty_380_S835_R1_001.fastq.gz,22,21,1,0.0455,4.55
Empty_380_S835_R2_001.fastq.gz,22,22,0,0.0000,0.00
Empty_381_S836_R1_001.fastq.gz,28,23,5,0.1786,17.86
Empty_381_S836_R2_001.fastq.gz,28,28,0,0.0000,0.00
Empty_382_S837_R1_001.fastq.gz,40,34,6,0.1500,15.00
Empty_382_S837_R2_001.fastq.gz,40,38,2,0.0500,5.00
Empty_383_S838_R1_001.fastq.gz,35,35,0,0.0000,0.00
Empty_383_S838_R2_001.fastq.gz,35,35,0,0.0000,0.00
Empty_384_S839_R1_001.fastq.gz,30,28,2,0.0667,6.67
Empty_384_S839_R2_001.fastq.gz,30,29,1,0.0333,3.33
Empty_385_S840_R1_001.fastq.gz,56,52,4,0.0714,7.14
Empty_385_S840_R2_001.fastq.gz,56,56,0,0.0000,0.00
Empty_386_S841_R1_001.fastq.gz,1,1,0,0.0000,0.00
Empty_386_S841_R2_001.fastq.gz,1,1,0,0.0000,0.00
Empty_387_S842_R1_001.fastq.gz,7,2,5,0.7143,71.43
Empty_387_S842_R2_001.fastq.gz,7,4,3,0.4286,42.86
Empty_388_S843_R1_001.fastq.gz,2,2,0,0.0000,0.00
Empty_388_S843_R2_001.fastq.gz,2,2,0,0.0000,0.00
Empty_389_S844_R1_001.fastq.gz,3,2,1,0.3333,33.33
Empty_389_S844_R2_001.fastq.gz,3,3,0,0.0000,0.00
Empty_38_S38_R1_001.fastq.gz,2,1,1,0.5000,50.00
Empty_38_S38_R2_001.fastq.gz,2,2,0,0.0000,0.00
Empty_390_S845_R1_001.fastq.gz,2,1,1,0.5000,50.00
Empty_390_S845_R2_001.fastq.gz,2,1,1,0.5000,50.00
Empty_391_S846_R1_001.fastq.gz,3,3,0,0.0000,0.00
Empty_391_S846_R2_001.fastq.gz,3,3,0,0.0000,0.00
Empty_392_S847_R1_001.fastq.gz,0,0,0,0.0000,0.00
Empty_392_S847_R2_001.fastq.gz,0,0,0,0.0000,0.00
Empty_393_S848_R1_001.fastq.gz,0,0,0,0.0000,0.00
Empty_393_S848_R2_001.fastq.gz,0,0,0,0.0000,0.00
Empty_394_S849_R1_001.fastq.gz,3,3,0,0.0000,0.00
Empty_394_S849_R2_001.fastq.gz,3,3,0,0.0000,0.00
Empty_395_S850_R1_001.fastq.gz,1,1,0,0.0000,0.00
Empty_395_S850_R2_001.fastq.gz,1,1,0,0.0000,0.00
Empty_396_S851_R1_001.fastq.gz,2,2,0,0.0000,0.00
Empty_396_S851_R2_001.fastq.gz,2,2,0,0.0000,0.00
Empty_397_S852_R1_001.fastq.gz,1,1,0,0.0000,0.00
Empty_397_S852_R2_001.fastq.gz,1,1,0,0.0000,0.00
Empty_398_S853_R1_001.fastq.gz,2,2,0,0.0000,0.00
Empty_398_S853_R2_001.fastq.gz,2,2,0,0.0000,0.00
Empty_399_S854_R1_001.fastq.gz,0,0,0,0.0000,0.00
Empty_399_S854_R2_001.fastq.gz,0,0,0,0.0000,0.00
Empty_39_S39_R1_001.fastq.gz,2,2,0,0.0000,0.00
Empty_39_S39_R2_001.fastq.gz,2,2,0,0.0000,0.00
Empty_3_S3_R1_001.fastq.gz,1,1,0,0.0000,0.00
Empty_3_S3_R2_001.fastq.gz,1,1,0,0.0000,0.00
Empty_400_S855_R1_001.fastq.gz,2,2,0,0.0000,0.00
Empty_400_S855_R2_001.fastq.gz,2,2,0,0.0000,0.00
Empty_401_S856_R1_001.fastq.gz,6,6,0,0.0000,0.00
Empty_401_S856_R2_001.fastq.gz,6,6,0,0.0000,0.00
Empty_402_S857_R1_001.fastq.gz,9,8,1,0.1111,11.11
Empty_402_S857_R2_001.fastq.gz,9,8,1,0.1111,11.11
Empty_403_S858_R1_001.fastq.gz,13,12,1,0.0769,7.69
Empty_403_S858_R2_001.fastq.gz,13,13,0,0.0000,0.00
Empty_404_S859_R1_001.fastq.gz,6,6,0,0.0000,0.00
Empty_404_S859_R2_001.fastq.gz,6,6,0,0.0000,0.00
Empty_405_S860_R1_001.fastq.gz,13,13,0,0.0000,0.00
Empty_405_S860_R2_001.fastq.gz,13,10,3,0.2308,23.08
Empty_406_S861_R1_001.fastq.gz,15,15,0,0.0000,0.00
Empty_406_S861_R2_001.fastq.gz,15,14,1,0.0667,6.67
Empty_407_S862_R1_001.fastq.gz,8,7,1,0.1250,12.50
Empty_407_S862_R2_001.fastq.gz,8,5,3,0.3750,37.50
Empty_408_S863_R1_001.fastq.gz,15,13,2,0.1333,13.33
Empty_408_S863_R2_001.fastq.gz,15,14,1,0.0667,6.67
Empty_409_S864_R1_001.fastq.gz,11,11,0,0.0000,0.00
Empty_409_S864_R2_001.fastq.gz,11,10,1,0.0909,9.09
Empty_40_S40_R1_001.fastq.gz,1,1,0,0.0000,0.00
Empty_40_S40_R2_001.fastq.gz,1,1,0,0.0000,0.00
Empty_410_S872_R1_001.fastq.gz,455295,73016,382279,0.8396,83.96
Empty_410_S872_R2_001.fastq.gz,455295,129168,326127,0.7163,71.63
Empty_411_S890_R1_001.fastq.gz,343329,53007,290322,0.8456,84.56
Empty_411_S890_R2_001.fastq.gz,343329,97999,245330,0.7146,71.46
Empty_412_S891_R1_001.fastq.gz,396116,55624,340492,0.8596,85.96
Empty_412_S891_R2_001.fastq.gz,396116,100210,295906,0.7470,74.70
Empty_413_S926_R1_001.fastq.gz,294127,33940,260187,0.8846,88.46
Empty_413_S926_R2_001.fastq.gz,294127,61235,232892,0.7918,79.18
Empty_414_S938_R1_001.fastq.gz,371790,75287,296503,0.7975,79.75
Empty_414_S938_R2_001.fastq.gz,371790,106468,265322,0.7136,71.36
Empty_415_S939_R1_001.fastq.gz,394237,85799,308438,0.7824,78.24
Empty_415_S939_R2_001.fastq.gz,394237,123792,270445,0.6860,68.60
Empty_416_S944_R1_001.fastq.gz,429713,94724,334989,0.7796,77.96
Empty_416_S944_R2_001.fastq.gz,429713,130902,298811,0.6954,69.54
Empty_417_S948_R1_001.fastq.gz,422050,63370,358680,0.8499,84.99
Empty_417_S948_R2_001.fastq.gz,422050,108685,313365,0.7425,74.25
Empty_418_S968_R1_001.fastq.gz,493889,56404,437485,0.8858,88.58
Empty_418_S968_R2_001.fastq.gz,493889,155018,338871,0.6861,68.61
Empty_419_S1022_R1_001.fastq.gz,270025,31283,238742,0.8841,88.41
Empty_419_S1022_R2_001.fastq.gz,270025,72646,197379,0.7310,73.10
Empty_41_S41_R1_001.fastq.gz,1,1,0,0.0000,0.00
Empty_41_S41_R2_001.fastq.gz,1,1,0,0.0000,0.00
Empty_420_S1034_R1_001.fastq.gz,538041,50704,487337,0.9058,90.58
Empty_420_S1034_R2_001.fastq.gz,538041,133454,404587,0.7520,75.20
Empty_421_S1035_R1_001.fastq.gz,351754,48471,303283,0.8622,86.22
Empty_421_S1035_R2_001.fastq.gz,351754,108525,243229,0.6915,69.15
Empty_422_S1040_R1_001.fastq.gz,463829,83797,380032,0.8193,81.93
Empty_422_S1040_R2_001.fastq.gz,463829,182420,281409,0.6067,60.67
Empty_423_S1044_R1_001.fastq.gz,275395,68610,206785,0.7509,75.09
Empty_423_S1044_R2_001.fastq.gz,275395,136253,139142,0.5052,50.52
Empty_424_S1057_R1_001.fastq.gz,186206,31889,154317,0.8287,82.87
Empty_424_S1057_R2_001.fastq.gz,186206,91108,95098,0.5107,51.07
Empty_425_S1060_R1_001.fastq.gz,344122,51469,292653,0.8504,85.04
Empty_425_S1060_R2_001.fastq.gz,344122,127305,216817,0.6301,63.01
Empty_426_S1071_R1_001.fastq.gz,386809,64709,322100,0.8327,83.27
Empty_426_S1071_R2_001.fastq.gz,386809,167205,219604,0.5677,56.77
Empty_427_S1128_R1_001.fastq.gz,13897,7566,6331,0.4556,45.56
Empty_427_S1128_R2_001.fastq.gz,13897,9924,3973,0.2859,28.59
Empty_428_S1140_R1_001.fastq.gz,16148,8722,7426,0.4599,45.99
Empty_428_S1140_R2_001.fastq.gz,16148,11481,4667,0.2890,28.90
Empty_429_S1141_R1_001.fastq.gz,363294,54902,308392,0.8489,84.89
Empty_429_S1141_R2_001.fastq.gz,363294,160400,202894,0.5585,55.85
Empty_42_S42_R1_001.fastq.gz,2,2,0,0.0000,0.00
Empty_42_S42_R2_001.fastq.gz,2,2,0,0.0000,0.00
Empty_430_S1149_R1_001.fastq.gz,14924,7871,7053,0.4726,47.26
Empty_430_S1149_R2_001.fastq.gz,14924,10183,4741,0.3177,31.77
Empty_431_S1153_R1_001.fastq.gz,0,0,0,0.0000,0.00
Empty_431_S1153_R2_001.fastq.gz,0,0,0,0.0000,0.00
Empty_432_S1154_R1_001.fastq.gz,0,0,0,0.0000,0.00
Empty_432_S1154_R2_001.fastq.gz,0,0,0,0.0000,0.00
Empty_433_S1155_R1_001.fastq.gz,0,0,0,0.0000,0.00
Empty_433_S1155_R2_001.fastq.gz,0,0,0,0.0000,0.00
Empty_434_S1156_R1_001.fastq.gz,0,0,0,0.0000,0.00
Empty_434_S1156_R2_001.fastq.gz,0,0,0,0.0000,0.00
Empty_435_S1157_R1_001.fastq.gz,1,1,0,0.0000,0.00
Empty_435_S1157_R2_001.fastq.gz,1,1,0,0.0000,0.00
Empty_436_S1158_R1_001.fastq.gz,0,0,0,0.0000,0.00
Empty_436_S1158_R2_001.fastq.gz,0,0,0,0.0000,0.00
Empty_437_S1159_R1_001.fastq.gz,2,2,0,0.0000,0.00
Empty_437_S1159_R2_001.fastq.gz,2,2,0,0.0000,0.00
Empty_438_S1160_R1_001.fastq.gz,2,2,0,0.0000,0.00
Empty_438_S1160_R2_001.fastq.gz,2,2,0,0.0000,0.00
Empty_439_S1161_R1_001.fastq.gz,7,7,0,0.0000,0.00
Empty_439_S1161_R2_001.fastq.gz,7,7,0,0.0000,0.00
Empty_43_S43_R1_001.fastq.gz,4,4,0,0.0000,0.00
Empty_43_S43_R2_001.fastq.gz,4,4,0,0.0000,0.00
Empty_440_S1162_R1_001.fastq.gz,5,5,0,0.0000,0.00
Empty_440_S1162_R2_001.fastq.gz,5,5,0,0.0000,0.00
Empty_441_S1163_R1_001.fastq.gz,5,5,0,0.0000,0.00
Empty_441_S1163_R2_001.fastq.gz,5,5,0,0.0000,0.00
Empty_442_S1164_R1_001.fastq.gz,3,3,0,0.0000,0.00
Empty_442_S1164_R2_001.fastq.gz,3,3,0,0.0000,0.00
Empty_443_S1165_R1_001.fastq.gz,3,2,1,0.3333,33.33
Empty_443_S1165_R2_001.fastq.gz,3,3,0,0.0000,0.00
Empty_444_S1166_R1_001.fastq.gz,10,9,1,0.1000,10.00
Empty_444_S1166_R2_001.fastq.gz,10,10,0,0.0000,0.00
Empty_445_S1167_R1_001.fastq.gz,9,9,0,0.0000,0.00
Empty_445_S1167_R2_001.fastq.gz,9,9,0,0.0000,0.00
Empty_446_S1168_R1_001.fastq.gz,17,15,2,0.1176,11.76
Empty_446_S1168_R2_001.fastq.gz,17,17,0,0.0000,0.00
Empty_447_S1169_R1_001.fastq.gz,1,1,0,0.0000,0.00
Empty_447_S1169_R2_001.fastq.gz,1,1,0,0.0000,0.00
Empty_448_S1170_R1_001.fastq.gz,0,0,0,0.0000,0.00
Empty_448_S1170_R2_001.fastq.gz,0,0,0,0.0000,0.00
Empty_449_S1171_R1_001.fastq.gz,0,0,0,0.0000,0.00
Empty_449_S1171_R2_001.fastq.gz,0,0,0,0.0000,0.00
Empty_44_S44_R1_001.fastq.gz,2,2,0,0.0000,0.00
Empty_44_S44_R2_001.fastq.gz,2,2,0,0.0000,0.00
Empty_450_S1172_R1_001.fastq.gz,0,0,0,0.0000,0.00
Empty_450_S1172_R2_001.fastq.gz,0,0,0,0.0000,0.00
Empty_451_S1173_R1_001.fastq.gz,1,1,0,0.0000,0.00
Empty_451_S1173_R2_001.fastq.gz,1,1,0,0.0000,0.00
Empty_452_S1174_R1_001.fastq.gz,2,2,0,0.0000,0.00
Empty_452_S1174_R2_001.fastq.gz,2,2,0,0.0000,0.00
Empty_453_S1175_R1_001.fastq.gz,0,0,0,0.0000,0.00
Empty_453_S1175_R2_001.fastq.gz,0,0,0,0.0000,0.00
Empty_454_S1176_R1_001.fastq.gz,1,1,0,0.0000,0.00
Empty_454_S1176_R2_001.fastq.gz,1,1,0,0.0000,0.00
Empty_455_S1177_R1_001.fastq.gz,0,0,0,0.0000,0.00
Empty_455_S1177_R2_001.fastq.gz,0,0,0,0.0000,0.00
Empty_456_S1178_R1_001.fastq.gz,0,0,0,0.0000,0.00
Empty_456_S1178_R2_001.fastq.gz,0,0,0,0.0000,0.00
Empty_457_S1179_R1_001.fastq.gz,0,0,0,0.0000,0.00
Empty_457_S1179_R2_001.fastq.gz,0,0,0,0.0000,0.00
Empty_458_S1180_R1_001.fastq.gz,2,1,1,0.5000,50.00
Empty_458_S1180_R2_001.fastq.gz,2,2,0,0.0000,0.00
Empty_459_S1181_R1_001.fastq.gz,0,0,0,0.0000,0.00
Empty_459_S1181_R2_001.fastq.gz,0,0,0,0.0000,0.00
Empty_45_S45_R1_001.fastq.gz,8,6,2,0.2500,25.00
Empty_45_S45_R2_001.fastq.gz,8,8,0,0.0000,0.00
Empty_460_S1182_R1_001.fastq.gz,1,1,0,0.0000,0.00
Empty_460_S1182_R2_001.fastq.gz,1,1,0,0.0000,0.00
Empty_461_S1183_R1_001.fastq.gz,2,1,1,0.5000,50.00
Empty_461_S1183_R2_001.fastq.gz,2,1,1,0.5000,50.00
Empty_462_S1184_R1_001.fastq.gz,0,0,0,0.0000,0.00
Empty_462_S1184_R2_001.fastq.gz,0,0,0,0.0000,0.00
Empty_463_S1185_R1_001.fastq.gz,0,0,0,0.0000,0.00
Empty_463_S1185_R2_001.fastq.gz,0,0,0,0.0000,0.00
Empty_464_S1186_R1_001.fastq.gz,0,0,0,0.0000,0.00
Empty_464_S1186_R2_001.fastq.gz,0,0,0,0.0000,0.00
Empty_465_S1187_R1_001.fastq.gz,0,0,0,0.0000,0.00
Empty_465_S1187_R2_001.fastq.gz,0,0,0,0.0000,0.00
Empty_466_S1188_R1_001.fastq.gz,0,0,0,0.0000,0.00
Empty_466_S1188_R2_001.fastq.gz,0,0,0,0.0000,0.00
Empty_467_S1189_R1_001.fastq.gz,1,1,0,0.0000,0.00
Empty_467_S1189_R2_001.fastq.gz,1,1,0,0.0000,0.00
Empty_468_S1190_R1_001.fastq.gz,1,1,0,0.0000,0.00
Empty_468_S1190_R2_001.fastq.gz,1,1,0,0.0000,0.00
Empty_469_S1191_R1_001.fastq.gz,0,0,0,0.0000,0.00
Empty_469_S1191_R2_001.fastq.gz,0,0,0,0.0000,0.00
Empty_46_S46_R1_001.fastq.gz,2,2,0,0.0000,0.00
Empty_46_S46_R2_001.fastq.gz,2,2,0,0.0000,0.00
Empty_470_S1192_R1_001.fastq.gz,2,1,1,0.5000,50.00
Empty_470_S1192_R2_001.fastq.gz,2,2,0,0.0000,0.00
Empty_471_S1193_R1_001.fastq.gz,3,3,0,0.0000,0.00
Empty_471_S1193_R2_001.fastq.gz,3,3,0,0.0000,0.00
Empty_472_S1194_R1_001.fastq.gz,7,7,0,0.0000,0.00
Empty_472_S1194_R2_001.fastq.gz,7,7,0,0.0000,0.00
Empty_473_S1195_R1_001.fastq.gz,12,12,0,0.0000,0.00
Empty_473_S1195_R2_001.fastq.gz,12,12,0,0.0000,0.00
Empty_474_S1196_R1_001.fastq.gz,9,7,2,0.2222,22.22
Empty_474_S1196_R2_001.fastq.gz,9,9,0,0.0000,0.00
Empty_475_S1197_R1_001.fastq.gz,13,13,0,0.0000,0.00
Empty_475_S1197_R2_001.fastq.gz,13,13,0,0.0000,0.00
Empty_476_S1198_R1_001.fastq.gz,8,8,0,0.0000,0.00
Empty_476_S1198_R2_001.fastq.gz,8,8,0,0.0000,0.00
Empty_477_S1199_R1_001.fastq.gz,6,6,0,0.0000,0.00
Empty_477_S1199_R2_001.fastq.gz,6,6,0,0.0000,0.00
Empty_478_S1200_R1_001.fastq.gz,5,5,0,0.0000,0.00
Empty_478_S1200_R2_001.fastq.gz,5,5,0,0.0000,0.00
Empty_479_S1201_R1_001.fastq.gz,1,1,0,0.0000,0.00
Empty_479_S1201_R2_001.fastq.gz,1,1,0,0.0000,0.00
Empty_47_S47_R1_001.fastq.gz,1,1,0,0.0000,0.00
Empty_47_S47_R2_001.fastq.gz,1,1,0,0.0000,0.00
Empty_480_S1202_R1_001.fastq.gz,2,2,0,0.0000,0.00
Empty_480_S1202_R2_001.fastq.gz,2,2,0,0.0000,0.00
Empty_481_S1203_R1_001.fastq.gz,15,11,4,0.2667,26.67
Empty_481_S1203_R2_001.fastq.gz,15,14,1,0.0667,6.67
Empty_482_S1204_R1_001.fastq.gz,13,5,8,0.6154,61.54
Empty_482_S1204_R2_001.fastq.gz,13,8,5,0.3846,38.46
Empty_483_S1205_R1_001.fastq.gz,21,14,7,0.3333,33.33
Empty_483_S1205_R2_001.fastq.gz,21,20,1,0.0476,4.76
Empty_484_S1206_R1_001.fastq.gz,9,6,3,0.3333,33.33
Empty_484_S1206_R2_001.fastq.gz,9,9,0,0.0000,0.00
Empty_485_S1207_R1_001.fastq.gz,4,3,1,0.2500,25.00
Empty_485_S1207_R2_001.fastq.gz,4,4,0,0.0000,0.00
Empty_486_S1208_R1_001.fastq.gz,1,1,0,0.0000,0.00
Empty_486_S1208_R2_001.fastq.gz,1,1,0,0.0000,0.00
Empty_487_S1209_R1_001.fastq.gz,0,0,0,0.0000,0.00
Empty_487_S1209_R2_001.fastq.gz,0,0,0,0.0000,0.00
Empty_488_S1210_R1_001.fastq.gz,0,0,0,0.0000,0.00
Empty_488_S1210_R2_001.fastq.gz,0,0,0,0.0000,0.00
Empty_489_S1211_R1_001.fastq.gz,1,1,0,0.0000,0.00
Empty_489_S1211_R2_001.fastq.gz,1,1,0,0.0000,0.00
Empty_48_S48_R1_001.fastq.gz,9,8,1,0.1111,11.11
Empty_48_S48_R2_001.fastq.gz,9,9,0,0.0000,0.00
Empty_490_S1212_R1_001.fastq.gz,0,0,0,0.0000,0.00
Empty_490_S1212_R2_001.fastq.gz,0,0,0,0.0000,0.00
Empty_491_S1213_R1_001.fastq.gz,1,1,0,0.0000,0.00
Empty_491_S1213_R2_001.fastq.gz,1,1,0,0.0000,0.00
Empty_492_S1214_R1_001.fastq.gz,0,0,0,0.0000,0.00
Empty_492_S1214_R2_001.fastq.gz,0,0,0,0.0000,0.00
Empty_493_S1215_R1_001.fastq.gz,0,0,0,0.0000,0.00
Empty_493_S1215_R2_001.fastq.gz,0,0,0,0.0000,0.00
Empty_494_S1216_R1_001.fastq.gz,0,0,0,0.0000,0.00
Empty_494_S1216_R2_001.fastq.gz,0,0,0,0.0000,0.00
Empty_495_S1217_R1_001.fastq.gz,20,19,1,0.0500,5.00
Empty_495_S1217_R2_001.fastq.gz,20,19,1,0.0500,5.00
Empty_496_S1218_R1_001.fastq.gz,21,20,1,0.0476,4.76
Empty_496_S1218_R2_001.fastq.gz,21,21,0,0.0000,0.00
Empty_497_S1219_R1_001.fastq.gz,7,7,0,0.0000,0.00
Empty_497_S1219_R2_001.fastq.gz,7,7,0,0.0000,0.00
Empty_498_S1220_R1_001.fastq.gz,25,24,1,0.0400,4.00
Empty_498_S1220_R2_001.fastq.gz,25,23,2,0.0800,8.00
Empty_499_S1221_R1_001.fastq.gz,31,30,1,0.0323,3.23
Empty_499_S1221_R2_001.fastq.gz,31,29,2,0.0645,6.45
Empty_49_S49_R1_001.fastq.gz,3,3,0,0.0000,0.00
Empty_49_S49_R2_001.fastq.gz,3,3,0,0.0000,0.00
Empty_4_S4_R1_001.fastq.gz,2,2,0,0.0000,0.00
Empty_4_S4_R2_001.fastq.gz,2,2,0,0.0000,0.00
Empty_500_S1222_R1_001.fastq.gz,20,19,1,0.0500,5.00
Empty_500_S1222_R2_001.fastq.gz,20,18,2,0.1000,10.00
Empty_501_S1223_R1_001.fastq.gz,57,45,12,0.2105,21.05
Empty_501_S1223_R2_001.fastq.gz,57,43,14,0.2456,24.56
Empty_502_S1224_R1_001.fastq.gz,29,27,2,0.0690,6.90
Empty_502_S1224_R2_001.fastq.gz,29,27,2,0.0690,6.90
Empty_503_S1225_R1_001.fastq.gz,2,2,0,0.0000,0.00
Empty_503_S1225_R2_001.fastq.gz,2,2,0,0.0000,0.00
Empty_504_S1226_R1_001.fastq.gz,5,5,0,0.0000,0.00
Empty_504_S1226_R2_001.fastq.gz,5,5,0,0.0000,0.00
Empty_505_S1227_R1_001.fastq.gz,2,2,0,0.0000,0.00
Empty_505_S1227_R2_001.fastq.gz,2,2,0,0.0000,0.00
Empty_506_S1228_R1_001.fastq.gz,4,4,0,0.0000,0.00
Empty_506_S1228_R2_001.fastq.gz,4,4,0,0.0000,0.00
Empty_507_S1229_R1_001.fastq.gz,1,1,0,0.0000,0.00
Empty_507_S1229_R2_001.fastq.gz,1,1,0,0.0000,0.00
Empty_508_S1230_R1_001.fastq.gz,2,1,1,0.5000,50.00
Empty_508_S1230_R2_001.fastq.gz,2,2,0,0.0000,0.00
Empty_509_S1231_R1_001.fastq.gz,0,0,0,0.0000,0.00
Empty_509_S1231_R2_001.fastq.gz,0,0,0,0.0000,0.00
Empty_50_S50_R1_001.fastq.gz,14,11,3,0.2143,21.43
Empty_50_S50_R2_001.fastq.gz,14,10,4,0.2857,28.57
Empty_510_S1232_R1_001.fastq.gz,2,2,0,0.0000,0.00
Empty_510_S1232_R2_001.fastq.gz,2,2,0,0.0000,0.00
Empty_511_S1233_R1_001.fastq.gz,0,0,0,0.0000,0.00
Empty_511_S1233_R2_001.fastq.gz,0,0,0,0.0000,0.00
Empty_512_S1234_R1_001.fastq.gz,2,1,1,0.5000,50.00
Empty_512_S1234_R2_001.fastq.gz,2,2,0,0.0000,0.00
Empty_513_S1235_R1_001.fastq.gz,0,0,0,0.0000,0.00
Empty_513_S1235_R2_001.fastq.gz,0,0,0,0.0000,0.00
Empty_514_S1236_R1_001.fastq.gz,0,0,0,0.0000,0.00
Empty_514_S1236_R2_001.fastq.gz,0,0,0,0.0000,0.00
Empty_515_S1237_R1_001.fastq.gz,1,1,0,0.0000,0.00
Empty_515_S1237_R2_001.fastq.gz,1,1,0,0.0000,0.00
Empty_516_S1238_R1_001.fastq.gz,1,1,0,0.0000,0.00
Empty_516_S1238_R2_001.fastq.gz,1,1,0,0.0000,0.00
Empty_517_S1239_R1_001.fastq.gz,0,0,0,0.0000,0.00
Empty_517_S1239_R2_001.fastq.gz,0,0,0,0.0000,0.00
Empty_518_S1240_R1_001.fastq.gz,3,3,0,0.0000,0.00
Empty_518_S1240_R2_001.fastq.gz,3,3,0,0.0000,0.00
Empty_519_S1241_R1_001.fastq.gz,3,3,0,0.0000,0.00
Empty_519_S1241_R2_001.fastq.gz,3,3,0,0.0000,0.00
Empty_51_S51_R1_001.fastq.gz,13,8,5,0.3846,38.46
Empty_51_S51_R2_001.fastq.gz,13,8,5,0.3846,38.46
Empty_520_S1242_R1_001.fastq.gz,3,3,0,0.0000,0.00
Empty_520_S1242_R2_001.fastq.gz,3,3,0,0.0000,0.00
Empty_521_S1243_R1_001.fastq.gz,9,9,0,0.0000,0.00
Empty_521_S1243_R2_001.fastq.gz,9,9,0,0.0000,0.00
Empty_522_S1244_R1_001.fastq.gz,5,5,0,0.0000,0.00
Empty_522_S1244_R2_001.fastq.gz,5,5,0,0.0000,0.00
Empty_523_S1245_R1_001.fastq.gz,7,7,0,0.0000,0.00
Empty_523_S1245_R2_001.fastq.gz,7,7,0,0.0000,0.00
Empty_524_S1246_R1_001.fastq.gz,1,1,0,0.0000,0.00
Empty_524_S1246_R2_001.fastq.gz,1,1,0,0.0000,0.00
Empty_525_S1247_R1_001.fastq.gz,4,4,0,0.0000,0.00
Empty_525_S1247_R2_001.fastq.gz,4,4,0,0.0000,0.00
Empty_526_S1248_R1_001.fastq.gz,1,1,0,0.0000,0.00
Empty_526_S1248_R2_001.fastq.gz,1,1,0,0.0000,0.00
Empty_527_S1257_R1_001.fastq.gz,12807,6700,6107,0.4768,47.68
Empty_527_S1257_R2_001.fastq.gz,12807,8804,4003,0.3126,31.26
Empty_528_S1260_R1_001.fastq.gz,197403,29508,167895,0.8505,85.05
Empty_528_S1260_R2_001.fastq.gz,197403,67297,130106,0.6591,65.91
Empty_529_S1268_R1_001.fastq.gz,223765,26399,197366,0.8820,88.20
Empty_529_S1268_R2_001.fastq.gz,223765,79795,143970,0.6434,64.34
Empty_52_S52_R1_001.fastq.gz,1,1,0,0.0000,0.00
Empty_52_S52_R2_001.fastq.gz,1,1,0,0.0000,0.00
Empty_530_S1269_R1_001.fastq.gz,132995,16640,116355,0.8749,87.49
Empty_530_S1269_R2_001.fastq.gz,132995,49122,83873,0.6306,63.06
Empty_531_S1272_R1_001.fastq.gz,323757,29955,293802,0.9075,90.75
Empty_531_S1272_R2_001.fastq.gz,323757,99093,224664,0.6939,69.39
Empty_532_S1279_R1_001.fastq.gz,289691,29431,260260,0.8984,89.84
Empty_532_S1279_R2_001.fastq.gz,289691,97535,192156,0.6633,66.33
Empty_533_S1282_R1_001.fastq.gz,268479,25695,242784,0.9043,90.43
Empty_533_S1282_R2_001.fastq.gz,268479,93049,175430,0.6534,65.34
Empty_534_S1283_R1_001.fastq.gz,211525,23929,187596,0.8869,88.69
Empty_534_S1283_R2_001.fastq.gz,211525,76214,135311,0.6397,63.97
Empty_535_S1293_R1_001.fastq.gz,265196,41251,223945,0.8445,84.45
Empty_535_S1293_R2_001.fastq.gz,265196,98203,166993,0.6297,62.97
Empty_536_S1294_R1_001.fastq.gz,300949,47310,253639,0.8428,84.28
Empty_536_S1294_R2_001.fastq.gz,300949,107583,193366,0.6425,64.25
Empty_537_S1295_R1_001.fastq.gz,294096,42973,251123,0.8539,85.39
Empty_537_S1295_R2_001.fastq.gz,294096,102115,191981,0.6528,65.28
Empty_538_S1308_R1_001.fastq.gz,256170,41511,214659,0.8380,83.80
Empty_538_S1308_R2_001.fastq.gz,256170,92150,164020,0.6403,64.03
Empty_539_S1319_R1_001.fastq.gz,363216,56106,307110,0.8455,84.55
Empty_539_S1319_R2_001.fastq.gz,363216,124340,238876,0.6577,65.77
Empty_53_S53_R1_001.fastq.gz,3,3,0,0.0000,0.00
Empty_53_S53_R2_001.fastq.gz,3,3,0,0.0000,0.00
Empty_540_S1320_R1_001.fastq.gz,23881,13078,10803,0.4524,45.24
Empty_540_S1320_R2_001.fastq.gz,23881,16087,7794,0.3264,32.64
Empty_541_S1329_R1_001.fastq.gz,232306,22532,209774,0.9030,90.30
Empty_541_S1329_R2_001.fastq.gz,232306,82681,149625,0.6441,64.41
Empty_542_S1331_R1_001.fastq.gz,223150,23888,199262,0.8930,89.30
Empty_542_S1331_R2_001.fastq.gz,223150,76745,146405,0.6561,65.61
Empty_543_S1341_R1_001.fastq.gz,203612,26418,177194,0.8703,87.03
Empty_543_S1341_R2_001.fastq.gz,203612,85465,118147,0.5803,58.03
Empty_544_S1343_R1_001.fastq.gz,25960,12688,13272,0.5112,51.12
Empty_544_S1343_R2_001.fastq.gz,25960,17614,8346,0.3215,32.15
Empty_545_S1348_R1_001.fastq.gz,422973,68630,354343,0.8377,83.77
Empty_545_S1348_R2_001.fastq.gz,422973,130332,292641,0.6919,69.19
Empty_546_S1353_R1_001.fastq.gz,250647,47846,202801,0.8091,80.91
Empty_546_S1353_R2_001.fastq.gz,250647,82151,168496,0.6722,67.22
Empty_547_S1359_R1_001.fastq.gz,494790,70872,423918,0.8568,85.68
Empty_547_S1359_R2_001.fastq.gz,494790,131352,363438,0.7345,73.45
Empty_548_S1364_R1_001.fastq.gz,297150,42443,254707,0.8572,85.72
Empty_548_S1364_R2_001.fastq.gz,297150,76335,220815,0.7431,74.31
Empty_549_S1365_R1_001.fastq.gz,416956,72607,344349,0.8259,82.59
Empty_549_S1365_R2_001.fastq.gz,416956,128062,288894,0.6929,69.29
Empty_54_S54_R1_001.fastq.gz,5,4,1,0.2000,20.00
Empty_54_S54_R2_001.fastq.gz,5,4,1,0.2000,20.00
Empty_550_S1368_R1_001.fastq.gz,604397,95983,508414,0.8412,84.12
Empty_550_S1368_R2_001.fastq.gz,604397,186273,418124,0.6918,69.18
Empty_551_S1375_R1_001.fastq.gz,352710,55871,296839,0.8416,84.16
Empty_551_S1375_R2_001.fastq.gz,352710,112625,240085,0.6807,68.07
Empty_552_S1396_R1_001.fastq.gz,358888,66109,292779,0.8158,81.58
Empty_552_S1396_R2_001.fastq.gz,358888,97920,260968,0.7272,72.72
Empty_553_S1415_R1_001.fastq.gz,19490,10282,9208,0.4724,47.24
Empty_553_S1415_R2_001.fastq.gz,19490,13296,6194,0.3178,31.78
Empty_554_S1425_R1_001.fastq.gz,265691,47007,218684,0.8231,82.31
Empty_554_S1425_R2_001.fastq.gz,265691,90818,174873,0.6582,65.82
Empty_555_S1437_R1_001.fastq.gz,265424,49805,215619,0.8124,81.24
Empty_555_S1437_R2_001.fastq.gz,265424,87398,178026,0.6707,67.07
Empty_556_S1444_R1_001.fastq.gz,315381,28607,286774,0.9093,90.93
Empty_556_S1444_R2_001.fastq.gz,315381,68476,246905,0.7829,78.29
Empty_557_S1449_R1_001.fastq.gz,225456,30461,194995,0.8649,86.49
Empty_557_S1449_R2_001.fastq.gz,225456,75688,149768,0.6643,66.43
Empty_558_S1455_R1_001.fastq.gz,383745,27991,355754,0.9271,92.71
Empty_558_S1455_R2_001.fastq.gz,383745,82535,301210,0.7849,78.49
Empty_559_S1460_R1_001.fastq.gz,303978,38878,265100,0.8721,87.21
Empty_559_S1460_R2_001.fastq.gz,303978,110312,193666,0.6371,63.71
Empty_55_S55_R1_001.fastq.gz,11,8,3,0.2727,27.27
Empty_55_S55_R2_001.fastq.gz,11,9,2,0.1818,18.18
Empty_560_S1471_R1_001.fastq.gz,302545,37137,265408,0.8773,87.73
Empty_560_S1471_R2_001.fastq.gz,302545,86008,216537,0.7157,71.57
Empty_561_S1489_R1_001.fastq.gz,261076,55072,206004,0.7891,78.91
Empty_561_S1489_R2_001.fastq.gz,261076,119713,141363,0.5415,54.15
Empty_562_S1492_R1_001.fastq.gz,287879,45174,242705,0.8431,84.31
Empty_562_S1492_R2_001.fastq.gz,287879,97447,190432,0.6615,66.15
Empty_563_S1511_R1_001.fastq.gz,17686,8632,9054,0.5119,51.19
Empty_563_S1511_R2_001.fastq.gz,17686,12012,5674,0.3208,32.08
Empty_564_S1521_R1_001.fastq.gz,315798,66745,249053,0.7886,78.86
Empty_564_S1521_R2_001.fastq.gz,315798,140484,175314,0.5551,55.51
Empty_565_S1533_R1_001.fastq.gz,286689,41443,245246,0.8554,85.54
Empty_565_S1533_R2_001.fastq.gz,286689,90765,195924,0.6834,68.34
Empty_56_S56_R1_001.fastq.gz,8,4,4,0.5000,50.00
Empty_56_S56_R2_001.fastq.gz,8,5,3,0.3750,37.50
Empty_57_S57_R1_001.fastq.gz,1,1,0,0.0000,0.00
Empty_57_S57_R2_001.fastq.gz,1,1,0,0.0000,0.00
Empty_58_S58_R1_001.fastq.gz,1,1,0,0.0000,0.00
Empty_58_S58_R2_001.fastq.gz,1,1,0,0.0000,0.00
Empty_59_S59_R1_001.fastq.gz,0,0,0,0.0000,0.00
Empty_59_S59_R2_001.fastq.gz,0,0,0,0.0000,0.00
Empty_5_S5_R1_001.fastq.gz,0,0,0,0.0000,0.00
Empty_5_S5_R2_001.fastq.gz,0,0,0,0.0000,0.00
Empty_60_S60_R1_001.fastq.gz,0,0,0,0.0000,0.00
Empty_60_S60_R2_001.fastq.gz,0,0,0,0.0000,0.00
Empty_61_S61_R1_001.fastq.gz,1,1,0,0.0000,0.00
Empty_61_S61_R2_001.fastq.gz,1,1,0,0.0000,0.00
Empty_62_S62_R1_001.fastq.gz,0,0,0,0.0000,0.00
Empty_62_S62_R2_001.fastq.gz,0,0,0,0.0000,0.00
Empty_63_S63_R1_001.fastq.gz,0,0,0,0.0000,0.00
Empty_63_S63_R2_001.fastq.gz,0,0,0,0.0000,0.00
Empty_64_S64_R1_001.fastq.gz,2,2,0,0.0000,0.00
Empty_64_S64_R2_001.fastq.gz,2,2,0,0.0000,0.00
Empty_65_S65_R1_001.fastq.gz,6,4,2,0.3333,33.33
Empty_65_S65_R2_001.fastq.gz,6,5,1,0.1667,16.67
Empty_66_S66_R1_001.fastq.gz,8,8,0,0.0000,0.00
Empty_66_S66_R2_001.fastq.gz,8,7,1,0.1250,12.50
Empty_67_S67_R1_001.fastq.gz,4,4,0,0.0000,0.00
Empty_67_S67_R2_001.fastq.gz,4,4,0,0.0000,0.00
Empty_68_S68_R1_001.fastq.gz,29,27,2,0.0690,6.90
Empty_68_S68_R2_001.fastq.gz,29,29,0,0.0000,0.00
Empty_69_S69_R1_001.fastq.gz,3,3,0,0.0000,0.00
Empty_69_S69_R2_001.fastq.gz,3,3,0,0.0000,0.00
Empty_6_S6_R1_001.fastq.gz,2,2,0,0.0000,0.00
Empty_6_S6_R2_001.fastq.gz,2,2,0,0.0000,0.00
Empty_70_S70_R1_001.fastq.gz,19,18,1,0.0526,5.26
Empty_70_S70_R2_001.fastq.gz,19,19,0,0.0000,0.00
Empty_71_S71_R1_001.fastq.gz,5,5,0,0.0000,0.00
Empty_71_S71_R2_001.fastq.gz,5,5,0,0.0000,0.00
Empty_72_S72_R1_001.fastq.gz,33,30,3,0.0909,9.09
Empty_72_S72_R2_001.fastq.gz,33,33,0,0.0000,0.00
Empty_73_S73_R1_001.fastq.gz,0,0,0,0.0000,0.00
Empty_73_S73_R2_001.fastq.gz,0,0,0,0.0000,0.00
Empty_74_S74_R1_001.fastq.gz,0,0,0,0.0000,0.00
Empty_74_S74_R2_001.fastq.gz,0,0,0,0.0000,0.00
Empty_75_S75_R1_001.fastq.gz,2,1,1,0.5000,50.00
Empty_75_S75_R2_001.fastq.gz,2,1,1,0.5000,50.00
Empty_76_S76_R1_001.fastq.gz,0,0,0,0.0000,0.00
Empty_76_S76_R2_001.fastq.gz,0,0,0,0.0000,0.00
Empty_77_S77_R1_001.fastq.gz,0,0,0,0.0000,0.00
Empty_77_S77_R2_001.fastq.gz,0,0,0,0.0000,0.00
Empty_78_S78_R1_001.fastq.gz,0,0,0,0.0000,0.00
Empty_78_S78_R2_001.fastq.gz,0,0,0,0.0000,0.00
Empty_79_S79_R1_001.fastq.gz,1,1,0,0.0000,0.00
Empty_79_S79_R2_001.fastq.gz,1,1,0,0.0000,0.00
Empty_7_S7_R1_001.fastq.gz,2,2,0,0.0000,0.00
Empty_7_S7_R2_001.fastq.gz,2,2,0,0.0000,0.00
Empty_80_S80_R1_001.fastq.gz,0,0,0,0.0000,0.00
Empty_80_S80_R2_001.fastq.gz,0,0,0,0.0000,0.00
Empty_81_S81_R1_001.fastq.gz,0,0,0,0.0000,0.00
Empty_81_S81_R2_001.fastq.gz,0,0,0,0.0000,0.00
Empty_82_S82_R1_001.fastq.gz,2,1,1,0.5000,50.00
Empty_82_S82_R2_001.fastq.gz,2,2,0,0.0000,0.00
Empty_83_S83_R1_001.fastq.gz,1,1,0,0.0000,0.00
Empty_83_S83_R2_001.fastq.gz,1,1,0,0.0000,0.00
Empty_84_S84_R1_001.fastq.gz,1,1,0,0.0000,0.00
Empty_84_S84_R2_001.fastq.gz,1,1,0,0.0000,0.00
Empty_85_S85_R1_001.fastq.gz,0,0,0,0.0000,0.00
Empty_85_S85_R2_001.fastq.gz,0,0,0,0.0000,0.00
Empty_86_S86_R1_001.fastq.gz,2,2,0,0.0000,0.00
Empty_86_S86_R2_001.fastq.gz,2,2,0,0.0000,0.00
Empty_87_S87_R1_001.fastq.gz,0,0,0,0.0000,0.00
Empty_87_S87_R2_001.fastq.gz,0,0,0,0.0000,0.00
Empty_88_S88_R1_001.fastq.gz,2,2,0,0.0000,0.00
Empty_88_S88_R2_001.fastq.gz,2,2,0,0.0000,0.00
Empty_89_S89_R1_001.fastq.gz,5,4,1,0.2000,20.00
Empty_89_S89_R2_001.fastq.gz,5,5,0,0.0000,0.00
Empty_8_S8_R1_001.fastq.gz,3,3,0,0.0000,0.00
Empty_8_S8_R2_001.fastq.gz,3,3,0,0.0000,0.00
Empty_90_S90_R1_001.fastq.gz,2,2,0,0.0000,0.00
Empty_90_S90_R2_001.fastq.gz,2,2,0,0.0000,0.00
Empty_91_S91_R1_001.fastq.gz,6,6,0,0.0000,0.00
Empty_91_S91_R2_001.fastq.gz,6,5,1,0.1667,16.67
Empty_92_S92_R1_001.fastq.gz,7,7,0,0.0000,0.00
Empty_92_S92_R2_001.fastq.gz,7,7,0,0.0000,0.00
Empty_93_S93_R1_001.fastq.gz,4,4,0,0.0000,0.00
Empty_93_S93_R2_001.fastq.gz,4,4,0,0.0000,0.00
Empty_94_S94_R1_001.fastq.gz,7,6,1,0.1429,14.29
Empty_94_S94_R2_001.fastq.gz,7,7,0,0.0000,0.00
Empty_95_S95_R1_001.fastq.gz,5,5,0,0.0000,0.00
Empty_95_S95_R2_001.fastq.gz,5,5,0,0.0000,0.00
Empty_96_S96_R1_001.fastq.gz,9,9,0,0.0000,0.00
Empty_96_S96_R2_001.fastq.gz,9,9,0,0.0000,0.00
Empty_97_S103_R1_001.fastq.gz,51014,15223,35791,0.7016,70.16
Empty_97_S103_R2_001.fastq.gz,51014,25265,25749,0.5047,50.47
Empty_98_S105_R1_001.fastq.gz,22753,9095,13658,0.6003,60.03
Empty_98_S105_R2_001.fastq.gz,22753,13091,9662,0.4246,42.46
Empty_99_S106_R1_001.fastq.gz,147661,31592,116069,0.7861,78.61
Empty_99_S106_R2_001.fastq.gz,147661,56201,91460,0.6194,61.94
Empty_9_S9_R1_001.fastq.gz,0,0,0,0.0000,0.00
Empty_9_S9_R2_001.fastq.gz,0,0,0,0.0000,0.00
ITS-Blank1_S288_R1_001.fastq.gz,52227,15636,36591,0.7006,70.06
ITS-Blank1_S288_R2_001.fastq.gz,52227,30145,22082,0.4228,42.28
ITS-Blank2_S768_R1_001.fastq.gz,91294,21500,69794,0.7645,76.45
ITS-Blank2_S768_R2_001.fastq.gz,91294,41550,49744,0.5449,54.49
ITS-Blank3_S1344_R1_001.fastq.gz,25168,12741,12427,0.4938,49.38
ITS-Blank3_S1344_R2_001.fastq.gz,25168,17292,7876,0.3129,31.29
ITSmix-Blank1_S192_R1_001.fastq.gz,64190,24508,39682,0.6182,61.82
ITSmix-Blank1_S192_R2_001.fastq.gz,64190,42969,21221,0.3306,33.06
ITSmix-Blank2_S672_R1_001.fastq.gz,329590,81734,247856,0.7520,75.20
ITSmix-Blank2_S672_R2_001.fastq.gz,329590,159695,169895,0.5155,51.55
ITSmix-Blank3_S1152_R1_001.fastq.gz,165014,41031,123983,0.7513,75.13
ITSmix-Blank3_S1152_R2_001.fastq.gz,165014,71684,93330,0.5656,56.56
ITSmix-NL2_101_S97_R1_001.fastq.gz,14515,7515,7000,0.4823,48.23
ITSmix-NL2_101_S97_R2_001.fastq.gz,14515,9688,4827,0.3326,33.26
ITSmix-NL2_102_S98_R1_001.fastq.gz,44324,13376,30948,0.6982,69.82
ITSmix-NL2_102_S98_R2_001.fastq.gz,44324,22545,21779,0.4914,49.14
ITSmix-NL2_103_S99_R1_001.fastq.gz,50102,15489,34613,0.6909,69.09
ITSmix-NL2_103_S99_R2_001.fastq.gz,50102,24501,25601,0.5110,51.10
ITSmix-NL2_104_S100_R1_001.fastq.gz,26131,10609,15522,0.5940,59.40
ITSmix-NL2_104_S100_R2_001.fastq.gz,26131,15563,10568,0.4044,40.44
ITSmix-NL2_105_S101_R1_001.fastq.gz,24261,9372,14889,0.6137,61.37
ITSmix-NL2_105_S101_R2_001.fastq.gz,24261,13926,10335,0.4260,42.60
ITSmix-NL2_106_S102_R1_001.fastq.gz,50134,21299,28835,0.5752,57.52
ITSmix-NL2_106_S102_R2_001.fastq.gz,50134,26964,23170,0.4622,46.22
ITSmix-NL2_108_S104_R1_001.fastq.gz,71602,21045,50557,0.7061,70.61
ITSmix-NL2_108_S104_R2_001.fastq.gz,71602,37328,34274,0.4787,47.87
ITSmix-NL2_10_S586_R1_001.fastq.gz,6127,3633,2494,0.4071,40.71
ITSmix-NL2_10_S586_R2_001.fastq.gz,6127,4901,1226,0.2001,20.01
ITSmix-NL2_111_S107_R1_001.fastq.gz,121052,28147,92905,0.7675,76.75
ITSmix-NL2_111_S107_R2_001.fastq.gz,121052,46878,74174,0.6127,61.27
ITSmix-NL2_112_S108_R1_001.fastq.gz,128714,36557,92157,0.7160,71.60
ITSmix-NL2_112_S108_R2_001.fastq.gz,128714,54535,74179,0.5763,57.63
ITSmix-NL2_113_S109_R1_001.fastq.gz,53761,14205,39556,0.7358,73.58
ITSmix-NL2_113_S109_R2_001.fastq.gz,53761,25208,28553,0.5311,53.11
ITSmix-NL2_114_S110_R1_001.fastq.gz,15703,8164,7539,0.4801,48.01
ITSmix-NL2_114_S110_R2_001.fastq.gz,15703,10089,5614,0.3575,35.75
ITSmix-NL2_117_S113_R1_001.fastq.gz,67184,22212,44972,0.6694,66.94
ITSmix-NL2_117_S113_R2_001.fastq.gz,67184,34725,32459,0.4831,48.31
ITSmix-NL2_118_S114_R1_001.fastq.gz,9491,5146,4345,0.4578,45.78
ITSmix-NL2_118_S114_R2_001.fastq.gz,9491,6588,2903,0.3059,30.59
ITSmix-NL2_11_S587_R1_001.fastq.gz,395221,89900,305321,0.7725,77.25
ITSmix-NL2_11_S587_R2_001.fastq.gz,395221,146652,248569,0.6289,62.89
ITSmix-NL2_120_S116_R1_001.fastq.gz,10636,6049,4587,0.4313,43.13
ITSmix-NL2_120_S116_R2_001.fastq.gz,10636,7536,3100,0.2915,29.15
ITSmix-NL2_121_S117_R1_001.fastq.gz,9363,5214,4149,0.4431,44.31
ITSmix-NL2_121_S117_R2_001.fastq.gz,9363,6479,2884,0.3080,30.80
ITSmix-NL2_122_S118_R1_001.fastq.gz,61422,17469,43953,0.7156,71.56
ITSmix-NL2_122_S118_R2_001.fastq.gz,61422,29271,32151,0.5234,52.34
ITSmix-NL2_123_S119_R1_001.fastq.gz,10190,5530,4660,0.4573,45.73
ITSmix-NL2_123_S119_R2_001.fastq.gz,10190,6924,3266,0.3205,32.05
ITSmix-NL2_125_S121_R1_001.fastq.gz,94962,32446,62516,0.6583,65.83
ITSmix-NL2_125_S121_R2_001.fastq.gz,94962,42036,52926,0.5573,55.73
ITSmix-NL2_126_S122_R1_001.fastq.gz,12266,6586,5680,0.4631,46.31
ITSmix-NL2_126_S122_R2_001.fastq.gz,12266,8382,3884,0.3166,31.66
ITSmix-NL2_127_S123_R1_001.fastq.gz,13253,7146,6107,0.4608,46.08
ITSmix-NL2_127_S123_R2_001.fastq.gz,13253,8972,4281,0.3230,32.30
ITSmix-NL2_129_S125_R1_001.fastq.gz,100348,24200,76148,0.7588,75.88
ITSmix-NL2_129_S125_R2_001.fastq.gz,100348,40493,59855,0.5965,59.65
ITSmix-NL2_12_S588_R1_001.fastq.gz,374243,66548,307695,0.8222,82.22
ITSmix-NL2_12_S588_R2_001.fastq.gz,374243,136390,237853,0.6356,63.56
ITSmix-NL2_133_S129_R1_001.fastq.gz,66751,17981,48770,0.7306,73.06
ITSmix-NL2_133_S129_R2_001.fastq.gz,66751,32171,34580,0.5180,51.80
ITSmix-NL2_136_S132_R1_001.fastq.gz,14735,7972,6763,0.4590,45.90
ITSmix-NL2_136_S132_R2_001.fastq.gz,14735,10186,4549,0.3087,30.87
ITSmix-NL2_137a_S133_R1_001.fastq.gz,131938,33892,98046,0.7431,74.31
ITSmix-NL2_137a_S133_R2_001.fastq.gz,131938,59142,72796,0.5517,55.17
ITSmix-NL2_137b_S134_R1_001.fastq.gz,132652,28962,103690,0.7817,78.17
ITSmix-NL2_137b_S134_R2_001.fastq.gz,132652,50363,82289,0.6203,62.03
ITSmix-NL2_138_S637_R1_001.fastq.gz,407728,90663,317065,0.7776,77.76
ITSmix-NL2_138_S637_R2_001.fastq.gz,407728,152698,255030,0.6255,62.55
ITSmix-NL2_139_S135_R1_001.fastq.gz,114397,25694,88703,0.7754,77.54
ITSmix-NL2_139_S135_R2_001.fastq.gz,114397,48638,65759,0.5748,57.48
ITSmix-NL2_13_S589_R1_001.fastq.gz,404208,88845,315363,0.7802,78.02
ITSmix-NL2_13_S589_R2_001.fastq.gz,404208,152678,251530,0.6223,62.23
ITSmix-NL2_140_S136_R1_001.fastq.gz,139342,38438,100904,0.7241,72.41
ITSmix-NL2_140_S136_R2_001.fastq.gz,139342,68098,71244,0.5113,51.13
ITSmix-NL2_141_S137_R1_001.fastq.gz,192850,37591,155259,0.8051,80.51
ITSmix-NL2_141_S137_R2_001.fastq.gz,192850,67060,125790,0.6523,65.23
ITSmix-NL2_142_S138_R1_001.fastq.gz,111227,26412,84815,0.7625,76.25
ITSmix-NL2_142_S138_R2_001.fastq.gz,111227,47248,63979,0.5752,57.52
ITSmix-NL2_143_S139_R1_001.fastq.gz,172818,36539,136279,0.7886,78.86
ITSmix-NL2_143_S139_R2_001.fastq.gz,172818,63553,109265,0.6323,63.23
ITSmix-NL2_144_S140_R1_001.fastq.gz,105131,34501,70630,0.6718,67.18
ITSmix-NL2_144_S140_R2_001.fastq.gz,105131,49813,55318,0.5262,52.62
ITSmix-NL2_146_S142_R1_001.fastq.gz,96404,29537,66867,0.6936,69.36
ITSmix-NL2_146_S142_R2_001.fastq.gz,96404,43916,52488,0.5445,54.45
ITSmix-NL2_148_S144_R1_001.fastq.gz,215789,42332,173457,0.8038,80.38
ITSmix-NL2_148_S144_R2_001.fastq.gz,215789,92444,123345,0.5716,57.16
ITSmix-NL2_149_S145_R1_001.fastq.gz,13681,6987,6694,0.4893,48.93
ITSmix-NL2_149_S145_R2_001.fastq.gz,13681,9192,4489,0.3281,32.81
ITSmix-NL2_14_S590_R1_001.fastq.gz,11483,6997,4486,0.3907,39.07
ITSmix-NL2_14_S590_R2_001.fastq.gz,11483,8909,2574,0.2242,22.42
ITSmix-NL2_150_S146_R1_001.fastq.gz,239174,39214,199960,0.8360,83.60
ITSmix-NL2_150_S146_R2_001.fastq.gz,239174,79191,159983,0.6689,66.89
ITSmix-NL2_152_S148_R1_001.fastq.gz,93395,30398,62997,0.6745,67.45
ITSmix-NL2_152_S148_R2_001.fastq.gz,93395,46521,46874,0.5019,50.19
ITSmix-NL2_153_S149_R1_001.fastq.gz,83637,20656,62981,0.7530,75.30
ITSmix-NL2_153_S149_R2_001.fastq.gz,83637,37916,45721,0.5467,54.67
ITSmix-NL2_155_S151_R1_001.fastq.gz,12816,6530,6286,0.4905,49.05
ITSmix-NL2_155_S151_R2_001.fastq.gz,12816,8343,4473,0.3490,34.90
ITSmix-NL2_158_S154_R1_001.fastq.gz,207860,45585,162275,0.7807,78.07
ITSmix-NL2_158_S154_R2_001.fastq.gz,207860,75369,132491,0.6374,63.74
ITSmix-NL2_15_S591_R1_001.fastq.gz,12273,7442,4831,0.3936,39.36
ITSmix-NL2_15_S591_R2_001.fastq.gz,12273,9548,2725,0.2220,22.20
ITSmix-NL2_160_S156_R1_001.fastq.gz,115403,29426,85977,0.7450,74.50
ITSmix-NL2_160_S156_R2_001.fastq.gz,115403,46797,68606,0.5945,59.45
ITSmix-NL2_161_S157_R1_001.fastq.gz,10075,5494,4581,0.4547,45.47
ITSmix-NL2_161_S157_R2_001.fastq.gz,10075,6795,3280,0.3256,32.56
ITSmix-NL2_162_S158_R1_001.fastq.gz,205688,42049,163639,0.7956,79.56
ITSmix-NL2_162_S158_R2_001.fastq.gz,205688,73557,132131,0.6424,64.24
ITSmix-NL2_163_S159_R1_001.fastq.gz,211899,43246,168653,0.7959,79.59
ITSmix-NL2_163_S159_R2_001.fastq.gz,211899,75160,136739,0.6453,64.53
ITSmix-NL2_164_S160_R1_001.fastq.gz,193601,39816,153785,0.7943,79.43
ITSmix-NL2_164_S160_R2_001.fastq.gz,193601,81945,111656,0.5767,57.67
ITSmix-NL2_166_S162_R1_001.fastq.gz,142887,31556,111331,0.7792,77.92
ITSmix-NL2_166_S162_R2_001.fastq.gz,142887,60260,82627,0.5783,57.83
ITSmix-NL2_167_S163_R1_001.fastq.gz,163340,64375,98965,0.6059,60.59
ITSmix-NL2_167_S163_R2_001.fastq.gz,163340,62644,100696,0.6165,61.65
ITSmix-NL2_169_S165_R1_001.fastq.gz,380661,68689,311972,0.8196,81.96
ITSmix-NL2_169_S165_R2_001.fastq.gz,380661,122253,258408,0.6788,67.88
ITSmix-NL2_172_S168_R1_001.fastq.gz,188624,46268,142356,0.7547,75.47
ITSmix-NL2_172_S168_R2_001.fastq.gz,188624,86801,101823,0.5398,53.98
ITSmix-NL2_173_S169_R1_001.fastq.gz,96553,31310,65243,0.6757,67.57
ITSmix-NL2_173_S169_R2_001.fastq.gz,96553,40110,56443,0.5846,58.46
ITSmix-NL2_174_S170_R1_001.fastq.gz,124408,52003,72405,0.5820,58.20
ITSmix-NL2_174_S170_R2_001.fastq.gz,124408,60748,63660,0.5117,51.17
ITSmix-NL2_177_S173_R1_001.fastq.gz,89222,29171,60051,0.6731,67.31
ITSmix-NL2_177_S173_R2_001.fastq.gz,89222,42603,46619,0.5225,52.25
ITSmix-NL2_17_S593_R1_001.fastq.gz,305476,80702,224774,0.7358,73.58
ITSmix-NL2_17_S593_R2_001.fastq.gz,305476,128083,177393,0.5807,58.07
ITSmix-NL2_180_S176_R1_001.fastq.gz,265548,55881,209667,0.7896,78.96
ITSmix-NL2_180_S176_R2_001.fastq.gz,265548,101660,163888,0.6172,61.72
ITSmix-NL2_182_S178_R1_001.fastq.gz,65859,17068,48791,0.7408,74.08
ITSmix-NL2_182_S178_R2_001.fastq.gz,65859,30791,35068,0.5325,53.25
ITSmix-NL2_183_S179_R1_001.fastq.gz,84972,26845,58127,0.6841,68.41
ITSmix-NL2_183_S179_R2_001.fastq.gz,84972,39584,45388,0.5342,53.42
ITSmix-NL2_184_S180_R1_001.fastq.gz,156474,35167,121307,0.7753,77.53
ITSmix-NL2_184_S180_R2_001.fastq.gz,156474,60407,96067,0.6139,61.39
ITSmix-NL2_185_S181_R1_001.fastq.gz,65372,16683,48689,0.7448,74.48
ITSmix-NL2_185_S181_R2_001.fastq.gz,65372,27639,37733,0.5772,57.72
ITSmix-NL2_187_S183_R1_001.fastq.gz,145489,39340,106149,0.7296,72.96
ITSmix-NL2_187_S183_R2_001.fastq.gz,145489,62267,83222,0.5720,57.20
ITSmix-NL2_188_S184_R1_001.fastq.gz,181327,38770,142557,0.7862,78.62
ITSmix-NL2_188_S184_R2_001.fastq.gz,181327,75282,106045,0.5848,58.48
ITSmix-NL2_189_S185_R1_001.fastq.gz,48799,16696,32103,0.6579,65.79
ITSmix-NL2_189_S185_R2_001.fastq.gz,48799,24802,23997,0.4918,49.18
ITSmix-NL2_18_S594_R1_001.fastq.gz,8563,4930,3633,0.4243,42.43
ITSmix-NL2_18_S594_R2_001.fastq.gz,8563,6594,1969,0.2299,22.99
ITSmix-NL2_190_S186_R1_001.fastq.gz,79681,21339,58342,0.7322,73.22
ITSmix-NL2_190_S186_R2_001.fastq.gz,79681,35643,44038,0.5527,55.27
ITSmix-NL2_191_S187_R1_001.fastq.gz,42563,14816,27747,0.6519,65.19
ITSmix-NL2_191_S187_R2_001.fastq.gz,42563,21658,20905,0.4912,49.12
ITSmix-NL2_192_S188_R1_001.fastq.gz,56757,21263,35494,0.6254,62.54
ITSmix-NL2_192_S188_R2_001.fastq.gz,56757,29113,27644,0.4871,48.71
ITSmix-NL2_193_S189_R1_001.fastq.gz,69347,25454,43893,0.6329,63.29
ITSmix-NL2_193_S189_R2_001.fastq.gz,69347,35179,34168,0.4927,49.27
ITSmix-NL2_196_S628_R1_001.fastq.gz,347841,107810,240031,0.6901,69.01
ITSmix-NL2_196_S628_R2_001.fastq.gz,347841,132785,215056,0.6183,61.83
ITSmix-NL2_197_S629_R1_001.fastq.gz,475522,149322,326200,0.6860,68.60
ITSmix-NL2_197_S629_R2_001.fastq.gz,475522,234463,241059,0.5069,50.69
ITSmix-NL2_198_S630_R1_001.fastq.gz,603335,179891,423444,0.7018,70.18
ITSmix-NL2_198_S630_R2_001.fastq.gz,603335,246070,357265,0.5922,59.22
ITSmix-NL2_199_S631_R1_001.fastq.gz,624086,121846,502240,0.8048,80.48
ITSmix-NL2_199_S631_R2_001.fastq.gz,624086,241368,382718,0.6132,61.32
ITSmix-NL2_19_S595_R1_001.fastq.gz,437676,85885,351791,0.8038,80.38
ITSmix-NL2_19_S595_R2_001.fastq.gz,437676,169233,268443,0.6133,61.33
ITSmix-NL2_1_S577_R1_001.fastq.gz,175784,49053,126731,0.7209,72.09
ITSmix-NL2_1_S577_R2_001.fastq.gz,175784,71468,104316,0.5934,59.34
ITSmix-NL2_201_S633_R1_001.fastq.gz,11954,6939,5015,0.4195,41.95
ITSmix-NL2_201_S633_R2_001.fastq.gz,11954,8930,3024,0.2530,25.30
ITSmix-NL2_202_S634_R1_001.fastq.gz,5942,3480,2462,0.4143,41.43
ITSmix-NL2_202_S634_R2_001.fastq.gz,5942,4627,1315,0.2213,22.13
ITSmix-NL2_203_S635_R1_001.fastq.gz,330885,113782,217103,0.6561,65.61
ITSmix-NL2_203_S635_R2_001.fastq.gz,330885,118895,211990,0.6407,64.07
ITSmix-NL2_204_S636_R1_001.fastq.gz,470108,94512,375596,0.7990,79.90
ITSmix-NL2_204_S636_R2_001.fastq.gz,470108,177768,292340,0.6219,62.19
ITSmix-NL2_20_S596_R1_001.fastq.gz,258663,64882,193781,0.7492,74.92
ITSmix-NL2_20_S596_R2_001.fastq.gz,258663,120901,137762,0.5326,53.26
ITSmix-NL2_21_S597_R1_001.fastq.gz,477477,114897,362580,0.7594,75.94
ITSmix-NL2_21_S597_R2_001.fastq.gz,477477,199299,278178,0.5826,58.26
ITSmix-NL2_22_S598_R1_001.fastq.gz,475828,111744,364084,0.7652,76.52
ITSmix-NL2_22_S598_R2_001.fastq.gz,475828,199065,276763,0.5816,58.16
ITSmix-NL2_23_S599_R1_001.fastq.gz,16366,9600,6766,0.4134,41.34
ITSmix-NL2_23_S599_R2_001.fastq.gz,16366,12518,3848,0.2351,23.51
ITSmix-NL2_24_S600_R1_001.fastq.gz,567838,114571,453267,0.7982,79.82
ITSmix-NL2_24_S600_R2_001.fastq.gz,567838,225551,342287,0.6028,60.28
ITSmix-NL2_25_S601_R1_001.fastq.gz,292372,65914,226458,0.7746,77.46
ITSmix-NL2_25_S601_R2_001.fastq.gz,292372,142320,150052,0.5132,51.32
ITSmix-NL2_26_S602_R1_001.fastq.gz,6356,3850,2506,0.3943,39.43
ITSmix-NL2_26_S602_R2_001.fastq.gz,6356,5166,1190,0.1872,18.72
ITSmix-NL2_28_S604_R1_001.fastq.gz,481005,112196,368809,0.7667,76.67
ITSmix-NL2_28_S604_R2_001.fastq.gz,481005,198410,282595,0.5875,58.75
ITSmix-NL2_29_S605_R1_001.fastq.gz,742697,173273,569424,0.7667,76.67
ITSmix-NL2_29_S605_R2_001.fastq.gz,742697,300466,442231,0.5954,59.54
ITSmix-NL2_2_S578_R1_001.fastq.gz,10456,5561,4895,0.4682,46.82
ITSmix-NL2_2_S578_R2_001.fastq.gz,10456,7926,2530,0.2420,24.20
ITSmix-NL2_30_S606_R1_001.fastq.gz,486458,104698,381760,0.7848,78.48
ITSmix-NL2_30_S606_R2_001.fastq.gz,486458,186613,299845,0.6164,61.64
ITSmix-NL2_31_S607_R1_001.fastq.gz,307390,52110,255280,0.8305,83.05
ITSmix-NL2_31_S607_R2_001.fastq.gz,307390,109735,197655,0.6430,64.30
ITSmix-NL2_32_S608_R1_001.fastq.gz,548377,146720,401657,0.7324,73.24
ITSmix-NL2_32_S608_R2_001.fastq.gz,548377,199033,349344,0.6371,63.71
ITSmix-NL2_33_S609_R1_001.fastq.gz,377809,76705,301104,0.7970,79.70
ITSmix-NL2_33_S609_R2_001.fastq.gz,377809,137305,240504,0.6366,63.66
ITSmix-NL2_34_S610_R1_001.fastq.gz,8941,5024,3917,0.4381,43.81
ITSmix-NL2_34_S610_R2_001.fastq.gz,8941,6839,2102,0.2351,23.51
ITSmix-NL2_35_S611_R1_001.fastq.gz,368869,82995,285874,0.7750,77.50
ITSmix-NL2_35_S611_R2_001.fastq.gz,368869,133200,235669,0.6389,63.89
ITSmix-NL2_36_S612_R1_001.fastq.gz,569803,158156,411647,0.7224,72.24
ITSmix-NL2_36_S612_R2_001.fastq.gz,569803,246929,322874,0.5666,56.66
ITSmix-NL2_37_S613_R1_001.fastq.gz,258968,58210,200758,0.7752,77.52
ITSmix-NL2_37_S613_R2_001.fastq.gz,258968,129119,129849,0.5014,50.14
ITSmix-NL2_38_S614_R1_001.fastq.gz,346806,80309,266497,0.7684,76.84
ITSmix-NL2_38_S614_R2_001.fastq.gz,346806,127766,219040,0.6316,63.16
ITSmix-NL2_39_S615_R1_001.fastq.gz,435891,104052,331839,0.7613,76.13
ITSmix-NL2_39_S615_R2_001.fastq.gz,435891,163754,272137,0.6243,62.43
ITSmix-NL2_3_S579_R1_001.fastq.gz,356575,71442,285133,0.7996,79.96
ITSmix-NL2_3_S579_R2_001.fastq.gz,356575,123806,232769,0.6528,65.28
ITSmix-NL2_40_S616_R1_001.fastq.gz,817574,154571,663003,0.8109,81.09
ITSmix-NL2_40_S616_R2_001.fastq.gz,817574,361896,455678,0.5574,55.74
ITSmix-NL2_41_S617_R1_001.fastq.gz,343542,70380,273162,0.7951,79.51
ITSmix-NL2_41_S617_R2_001.fastq.gz,343542,116664,226878,0.6604,66.04
ITSmix-NL2_42_S618_R1_001.fastq.gz,8044,4862,3182,0.3956,39.56
ITSmix-NL2_42_S618_R2_001.fastq.gz,8044,6256,1788,0.2223,22.23
ITSmix-NL2_43_S619_R1_001.fastq.gz,202204,35558,166646,0.8241,82.41
ITSmix-NL2_43_S619_R2_001.fastq.gz,202204,65852,136352,0.6743,67.43
ITSmix-NL2_44_S620_R1_001.fastq.gz,246919,38954,207965,0.8422,84.22
ITSmix-NL2_44_S620_R2_001.fastq.gz,246919,91914,155005,0.6278,62.78
ITSmix-NL2_45_S621_R1_001.fastq.gz,391803,73169,318634,0.8133,81.33
ITSmix-NL2_45_S621_R2_001.fastq.gz,391803,146444,245359,0.6262,62.62
ITSmix-NL2_46_S622_R1_001.fastq.gz,513662,193593,320069,0.6231,62.31
ITSmix-NL2_46_S622_R2_001.fastq.gz,513662,260149,253513,0.4935,49.35
ITSmix-NL2_47_S623_R1_001.fastq.gz,674596,169005,505591,0.7495,74.95
ITSmix-NL2_47_S623_R2_001.fastq.gz,674596,256881,417715,0.6192,61.92
ITSmix-NL2_48_S624_R1_001.fastq.gz,430248,101716,328532,0.7636,76.36
ITSmix-NL2_48_S624_R2_001.fastq.gz,430248,154175,276073,0.6417,64.17
ITSmix-NL2_49_S625_R1_001.fastq.gz,350863,92471,258392,0.7364,73.64
ITSmix-NL2_49_S625_R2_001.fastq.gz,350863,146595,204268,0.5822,58.22
ITSmix-NL2_4_S580_R1_001.fastq.gz,322723,74942,247781,0.7678,76.78
ITSmix-NL2_4_S580_R2_001.fastq.gz,322723,139862,182861,0.5666,56.66
ITSmix-NL2_50_S626_R1_001.fastq.gz,7971,4563,3408,0.4275,42.75
ITSmix-NL2_50_S626_R2_001.fastq.gz,7971,6090,1881,0.2360,23.60
ITSmix-NL2_51_S627_R1_001.fastq.gz,344446,126503,217943,0.6327,63.27
ITSmix-NL2_51_S627_R2_001.fastq.gz,344446,123290,221156,0.6421,64.21
ITSmix-NL2_5_S581_R1_001.fastq.gz,527326,109715,417611,0.7919,79.19
ITSmix-NL2_5_S581_R2_001.fastq.gz,527326,204722,322604,0.6118,61.18
ITSmix-NL2_6_S582_R1_001.fastq.gz,386711,75276,311435,0.8053,80.53
ITSmix-NL2_6_S582_R2_001.fastq.gz,386711,146942,239769,0.6200,62.00
ITSmix-NL2_7_S583_R1_001.fastq.gz,560244,193539,366705,0.6545,65.45
ITSmix-NL2_7_S583_R2_001.fastq.gz,560244,215585,344659,0.6152,61.52
ITSmix-NL2_9_S585_R1_001.fastq.gz,440550,151232,289318,0.6567,65.67
ITSmix-NL2_9_S585_R2_001.fastq.gz,440550,174123,266427,0.6048,60.48
ITSmix-SB_100_S1092_R1_001.fastq.gz,407011,57566,349445,0.8586,85.86
ITSmix-SB_100_S1092_R2_001.fastq.gz,407011,149029,257982,0.6338,63.38
ITSmix-SB_101_S1093_R1_001.fastq.gz,381124,51899,329225,0.8638,86.38
ITSmix-SB_101_S1093_R2_001.fastq.gz,381124,122716,258408,0.6780,67.80
ITSmix-SB_102_S1094_R1_001.fastq.gz,320715,43784,276931,0.8635,86.35
ITSmix-SB_102_S1094_R2_001.fastq.gz,320715,128861,191854,0.5982,59.82
ITSmix-SB_103_S1095_R1_001.fastq.gz,348857,60805,288052,0.8257,82.57
ITSmix-SB_103_S1095_R2_001.fastq.gz,348857,125896,222961,0.6391,63.91
ITSmix-SB_104_S1096_R1_001.fastq.gz,552869,86258,466611,0.8440,84.40
ITSmix-SB_104_S1096_R2_001.fastq.gz,552869,199406,353463,0.6393,63.93
ITSmix-SB_105_S1097_R1_001.fastq.gz,164714,28629,136085,0.8262,82.62
ITSmix-SB_105_S1097_R2_001.fastq.gz,164714,64205,100509,0.6102,61.02
ITSmix-SB_106_S1098_R1_001.fastq.gz,216409,32799,183610,0.8484,84.84
ITSmix-SB_106_S1098_R2_001.fastq.gz,216409,78452,137957,0.6375,63.75
ITSmix-SB_107_S1099_R1_001.fastq.gz,445786,51127,394659,0.8853,88.53
ITSmix-SB_107_S1099_R2_001.fastq.gz,445786,138183,307603,0.6900,69.00
ITSmix-SB_108_S1100_R1_001.fastq.gz,298476,49933,248543,0.8327,83.27
ITSmix-SB_108_S1100_R2_001.fastq.gz,298476,97981,200495,0.6717,67.17
ITSmix-SB_109_S1101_R1_001.fastq.gz,290358,59921,230437,0.7936,79.36
ITSmix-SB_109_S1101_R2_001.fastq.gz,290358,109410,180948,0.6232,62.32
ITSmix-SB_110_S1102_R1_001.fastq.gz,307247,65544,241703,0.7867,78.67
ITSmix-SB_110_S1102_R2_001.fastq.gz,307247,103984,203263,0.6616,66.16
ITSmix-SB_111_S1103_R1_001.fastq.gz,295919,51695,244224,0.8253,82.53
ITSmix-SB_111_S1103_R2_001.fastq.gz,295919,109375,186544,0.6304,63.04
ITSmix-SB_112_S1104_R1_001.fastq.gz,509114,49386,459728,0.9030,90.30
ITSmix-SB_112_S1104_R2_001.fastq.gz,509114,140628,368486,0.7238,72.38
ITSmix-SB_113_S1105_R1_001.fastq.gz,148181,23673,124508,0.8402,84.02
ITSmix-SB_113_S1105_R2_001.fastq.gz,148181,50883,97298,0.6566,65.66
ITSmix-SB_114_S1106_R1_001.fastq.gz,345626,46323,299303,0.8660,86.60
ITSmix-SB_114_S1106_R2_001.fastq.gz,345626,118237,227389,0.6579,65.79
ITSmix-SB_115_S1107_R1_001.fastq.gz,13244,7158,6086,0.4595,45.95
ITSmix-SB_115_S1107_R2_001.fastq.gz,13244,9508,3736,0.2821,28.21
ITSmix-SB_116_S1108_R1_001.fastq.gz,214336,46375,167961,0.7836,78.36
ITSmix-SB_116_S1108_R2_001.fastq.gz,214336,86976,127360,0.5942,59.42
ITSmix-SB_117_S1109_R1_001.fastq.gz,318640,47291,271349,0.8516,85.16
ITSmix-SB_117_S1109_R2_001.fastq.gz,318640,110571,208069,0.6530,65.30
ITSmix-SB_118_S1110_R1_001.fastq.gz,469376,57409,411967,0.8777,87.77
ITSmix-SB_118_S1110_R2_001.fastq.gz,469376,167268,302108,0.6436,64.36
ITSmix-SB_119_S1111_R1_001.fastq.gz,566997,92936,474061,0.8361,83.61
ITSmix-SB_119_S1111_R2_001.fastq.gz,566997,217976,349021,0.6156,61.56
ITSmix-SB_120_S1112_R1_001.fastq.gz,349672,72084,277588,0.7939,79.39
ITSmix-SB_120_S1112_R2_001.fastq.gz,349672,137141,212531,0.6078,60.78
ITSmix-SB_121_S1113_R1_001.fastq.gz,341704,51502,290202,0.8493,84.93
ITSmix-SB_121_S1113_R2_001.fastq.gz,341704,130282,211422,0.6187,61.87
ITSmix-SB_122_S1114_R1_001.fastq.gz,13800,7484,6316,0.4577,45.77
ITSmix-SB_122_S1114_R2_001.fastq.gz,13800,9649,4151,0.3008,30.08
ITSmix-SB_123_S1115_R1_001.fastq.gz,248092,47866,200226,0.8071,80.71
ITSmix-SB_123_S1115_R2_001.fastq.gz,248092,86590,161502,0.6510,65.10
ITSmix-SB_124_S1116_R1_001.fastq.gz,314421,57673,256748,0.8166,81.66
ITSmix-SB_124_S1116_R2_001.fastq.gz,314421,106918,207503,0.6600,66.00
ITSmix-SB_125_S1117_R1_001.fastq.gz,315682,45844,269838,0.8548,85.48
ITSmix-SB_125_S1117_R2_001.fastq.gz,315682,114403,201279,0.6376,63.76
ITSmix-SB_126_S1118_R1_001.fastq.gz,221340,52713,168627,0.7618,76.18
ITSmix-SB_126_S1118_R2_001.fastq.gz,221340,85141,136199,0.6153,61.53
ITSmix-SB_127_S1119_R1_001.fastq.gz,452337,92027,360310,0.7966,79.66
ITSmix-SB_127_S1119_R2_001.fastq.gz,452337,166714,285623,0.6314,63.14
ITSmix-SB_128_S1120_R1_001.fastq.gz,338633,64162,274471,0.8105,81.05
ITSmix-SB_128_S1120_R2_001.fastq.gz,338633,118406,220227,0.6503,65.03
ITSmix-SB_129_S1121_R1_001.fastq.gz,10192,5629,4563,0.4477,44.77
ITSmix-SB_129_S1121_R2_001.fastq.gz,10192,7178,3014,0.2957,29.57
ITSmix-SB_12_S652_R1_001.fastq.gz,378699,105251,273448,0.7221,72.21
ITSmix-SB_12_S652_R2_001.fastq.gz,378699,150519,228180,0.6025,60.25
ITSmix-SB_130_S1122_R1_001.fastq.gz,11498,6077,5421,0.4715,47.15
ITSmix-SB_130_S1122_R2_001.fastq.gz,11498,7953,3545,0.3083,30.83
ITSmix-SB_131_S1123_R1_001.fastq.gz,149287,24150,125137,0.8382,83.82
ITSmix-SB_131_S1123_R2_001.fastq.gz,149287,57114,92173,0.6174,61.74
ITSmix-SB_132_S1124_R1_001.fastq.gz,11760,6369,5391,0.4584,45.84
ITSmix-SB_132_S1124_R2_001.fastq.gz,11760,8273,3487,0.2965,29.65
ITSmix-SB_133_S1125_R1_001.fastq.gz,278721,39021,239700,0.8600,86.00
ITSmix-SB_133_S1125_R2_001.fastq.gz,278721,95799,182922,0.6563,65.63
ITSmix-SB_134_S1126_R1_001.fastq.gz,263069,37446,225623,0.8577,85.77
ITSmix-SB_134_S1126_R2_001.fastq.gz,263069,88445,174624,0.6638,66.38
ITSmix-SB_135_S1127_R1_001.fastq.gz,9872,5480,4392,0.4449,44.49
ITSmix-SB_135_S1127_R2_001.fastq.gz,9872,7200,2672,0.2707,27.07
ITSmix-SB_137_S1129_R1_001.fastq.gz,382709,61529,321180,0.8392,83.92
ITSmix-SB_137_S1129_R2_001.fastq.gz,382709,133940,248769,0.6500,65.00
ITSmix-SB_138_S1130_R1_001.fastq.gz,307998,48699,259299,0.8419,84.19
ITSmix-SB_138_S1130_R2_001.fastq.gz,307998,126566,181432,0.5891,58.91
ITSmix-SB_139_S1131_R1_001.fastq.gz,15052,7966,7086,0.4708,47.08
ITSmix-SB_139_S1131_R2_001.fastq.gz,15052,10441,4611,0.3063,30.63
ITSmix-SB_140_S1132_R1_001.fastq.gz,18187,9626,8561,0.4707,47.07
ITSmix-SB_140_S1132_R2_001.fastq.gz,18187,12605,5582,0.3069,30.69
ITSmix-SB_141_S1133_R1_001.fastq.gz,300167,43335,256832,0.8556,85.56
ITSmix-SB_141_S1133_R2_001.fastq.gz,300167,107716,192451,0.6411,64.11
ITSmix-SB_142_S1134_R1_001.fastq.gz,278861,35968,242893,0.8710,87.10
ITSmix-SB_142_S1134_R2_001.fastq.gz,278861,90072,188789,0.6770,67.70
ITSmix-SB_143_S1135_R1_001.fastq.gz,300093,37845,262248,0.8739,87.39
ITSmix-SB_143_S1135_R2_001.fastq.gz,300093,105284,194809,0.6492,64.92
ITSmix-SB_144_S1136_R1_001.fastq.gz,296679,41058,255621,0.8616,86.16
ITSmix-SB_144_S1136_R2_001.fastq.gz,296679,103423,193256,0.6514,65.14
ITSmix-SB_145_S1138_R1_001.fastq.gz,403559,66786,336773,0.8345,83.45
ITSmix-SB_145_S1138_R2_001.fastq.gz,403559,180363,223196,0.5531,55.31
ITSmix-SB_146_S1137_R1_001.fastq.gz,256116,59688,196428,0.7669,76.69
ITSmix-SB_146_S1137_R2_001.fastq.gz,256116,108072,148044,0.5780,57.80
ITSmix-SB_147_S1139_R1_001.fastq.gz,13521,7239,6282,0.4646,46.46
ITSmix-SB_147_S1139_R2_001.fastq.gz,13521,9621,3900,0.2884,28.84
ITSmix-SB_14_S654_R1_001.fastq.gz,146223,29866,116357,0.7958,79.58
ITSmix-SB_14_S654_R2_001.fastq.gz,146223,46946,99277,0.6789,67.89
ITSmix-SB_150_S1142_R1_001.fastq.gz,16378,8601,7777,0.4748,47.48
ITSmix-SB_150_S1142_R2_001.fastq.gz,16378,11469,4909,0.2997,29.97
ITSmix-SB_151_S1143_R1_001.fastq.gz,14043,7881,6162,0.4388,43.88
ITSmix-SB_151_S1143_R2_001.fastq.gz,14043,10362,3681,0.2621,26.21
ITSmix-SB_152_S1144_R1_001.fastq.gz,18949,10198,8751,0.4618,46.18
ITSmix-SB_152_S1144_R2_001.fastq.gz,18949,13622,5327,0.2811,28.11
ITSmix-SB_153_S1145_R1_001.fastq.gz,10807,6094,4713,0.4361,43.61
ITSmix-SB_153_S1145_R2_001.fastq.gz,10807,7592,3215,0.2975,29.75
ITSmix-SB_154_S1146_R1_001.fastq.gz,13061,7054,6007,0.4599,45.99
ITSmix-SB_154_S1146_R2_001.fastq.gz,13061,9141,3920,0.3001,30.01
ITSmix-SB_155_S1147_R1_001.fastq.gz,328181,51289,276892,0.8437,84.37
ITSmix-SB_155_S1147_R2_001.fastq.gz,328181,94502,233679,0.7120,71.20
ITSmix-SB_156_S1148_R1_001.fastq.gz,149149,27122,122027,0.8182,81.82
ITSmix-SB_156_S1148_R2_001.fastq.gz,149149,59475,89674,0.6012,60.12
ITSmix-SB_158_S1150_R1_001.fastq.gz,12729,7026,5703,0.4480,44.80
ITSmix-SB_158_S1150_R2_001.fastq.gz,12729,8869,3860,0.3032,30.32
ITSmix-SB_159_S1151_R1_001.fastq.gz,371007,50292,320715,0.8644,86.44
ITSmix-SB_159_S1151_R2_001.fastq.gz,371007,142708,228299,0.6153,61.53
ITSmix-SB_15_S655_R1_001.fastq.gz,374595,87560,287035,0.7663,76.63
ITSmix-SB_15_S655_R2_001.fastq.gz,374595,150077,224518,0.5994,59.94
ITSmix-SB_161_S639_R1_001.fastq.gz,11008,6639,4369,0.3969,39.69
ITSmix-SB_161_S639_R2_001.fastq.gz,11008,8508,2500,0.2271,22.71
ITSmix-SB_162_S640_R1_001.fastq.gz,431352,76322,355030,0.8231,82.31
ITSmix-SB_162_S640_R2_001.fastq.gz,431352,161192,270160,0.6263,62.63
ITSmix-SB_17_S657_R1_001.fastq.gz,339302,81068,258234,0.7611,76.11
ITSmix-SB_17_S657_R2_001.fastq.gz,339302,155192,184110,0.5426,54.26
ITSmix-SB_18_S658_R1_001.fastq.gz,6350,3945,2405,0.3787,37.87
ITSmix-SB_18_S658_R2_001.fastq.gz,6350,5218,1132,0.1783,17.83
ITSmix-SB_19_S659_R1_001.fastq.gz,491490,145634,345856,0.7037,70.37
ITSmix-SB_19_S659_R2_001.fastq.gz,491490,227777,263713,0.5366,53.66
ITSmix-SB_1_S641_R1_001.fastq.gz,168020,40646,127374,0.7581,75.81
ITSmix-SB_1_S641_R2_001.fastq.gz,168020,67735,100285,0.5969,59.69
ITSmix-SB_20_S660_R1_001.fastq.gz,277109,49958,227151,0.8197,81.97
ITSmix-SB_20_S660_R2_001.fastq.gz,277109,90796,186313,0.6723,67.23
ITSmix-SB_21_S661_R1_001.fastq.gz,303652,63589,240063,0.7906,79.06
ITSmix-SB_21_S661_R2_001.fastq.gz,303652,162269,141383,0.4656,46.56
ITSmix-SB_22_S662_R1_001.fastq.gz,265129,38812,226317,0.8536,85.36
ITSmix-SB_22_S662_R2_001.fastq.gz,265129,92932,172197,0.6495,64.95
ITSmix-SB_23_S663_R1_001.fastq.gz,451817,81391,370426,0.8199,81.99
ITSmix-SB_23_S663_R2_001.fastq.gz,451817,175636,276181,0.6113,61.13
ITSmix-SB_24_S664_R1_001.fastq.gz,449686,120129,329557,0.7329,73.29
ITSmix-SB_24_S664_R2_001.fastq.gz,449686,179770,269916,0.6002,60.02
ITSmix-SB_25_S665_R1_001.fastq.gz,296956,71998,224958,0.7575,75.75
ITSmix-SB_25_S665_R2_001.fastq.gz,296956,136903,160053,0.5390,53.90
ITSmix-SB_26_S666_R1_001.fastq.gz,7599,4359,3240,0.4264,42.64
ITSmix-SB_26_S666_R2_001.fastq.gz,7599,5956,1643,0.2162,21.62
ITSmix-SB_27_S283_R1_001.fastq.gz,948777,239868,708909,0.7472,74.72
ITSmix-SB_27_S283_R2_001.fastq.gz,948777,330644,618133,0.6515,65.15
ITSmix-SB_28_S284_R1_001.fastq.gz,933750,139965,793785,0.8501,85.01
ITSmix-SB_28_S284_R2_001.fastq.gz,933750,307092,626658,0.6711,67.11
ITSmix-SB_29_S669_R1_001.fastq.gz,279146,49989,229157,0.8209,82.09
ITSmix-SB_29_S669_R2_001.fastq.gz,279146,101518,177628,0.6363,63.63
ITSmix-SB_2_S642_R1_001.fastq.gz,6575,3997,2578,0.3921,39.21
ITSmix-SB_2_S642_R2_001.fastq.gz,6575,5170,1405,0.2137,21.37
ITSmix-SB_30_S670_R1_001.fastq.gz,369906,69988,299918,0.8108,81.08
ITSmix-SB_30_S670_R2_001.fastq.gz,369906,145351,224555,0.6071,60.71
ITSmix-SB_31_S287_R1_001.fastq.gz,13654,7386,6268,0.4591,45.91
ITSmix-SB_31_S287_R2_001.fastq.gz,13654,9250,4404,0.3225,32.25
ITSmix-SB_5_S645_R1_001.fastq.gz,161242,54979,106263,0.6590,65.90
ITSmix-SB_5_S645_R2_001.fastq.gz,161242,71861,89381,0.5543,55.43
ITSmix-SB_66_S1058_R1_001.fastq.gz,211964,33356,178608,0.8426,84.26
ITSmix-SB_66_S1058_R2_001.fastq.gz,211964,76525,135439,0.6390,63.90
ITSmix-SB_67_S1059_R1_001.fastq.gz,439686,82940,356746,0.8114,81.14
ITSmix-SB_67_S1059_R2_001.fastq.gz,439686,178189,261497,0.5947,59.47
ITSmix-SB_69_S1061_R1_001.fastq.gz,312435,43877,268558,0.8596,85.96
ITSmix-SB_69_S1061_R2_001.fastq.gz,312435,111108,201327,0.6444,64.44
ITSmix-SB_6_S646_R1_001.fastq.gz,257031,68629,188402,0.7330,73.30
ITSmix-SB_6_S646_R2_001.fastq.gz,257031,108081,148950,0.5795,57.95
ITSmix-SB_70_S1062_R1_001.fastq.gz,302333,37568,264765,0.8757,87.57
ITSmix-SB_70_S1062_R2_001.fastq.gz,302333,95786,206547,0.6832,68.32
ITSmix-SB_71_S1063_R1_001.fastq.gz,400537,56949,343588,0.8578,85.78
ITSmix-SB_71_S1063_R2_001.fastq.gz,400537,146062,254475,0.6353,63.53
ITSmix-SB_72_S1064_R1_001.fastq.gz,713853,109215,604638,0.8470,84.70
ITSmix-SB_72_S1064_R2_001.fastq.gz,713853,218834,495019,0.6934,69.34
ITSmix-SB_73_S1065_R1_001.fastq.gz,358443,59563,298880,0.8338,83.38
ITSmix-SB_73_S1065_R2_001.fastq.gz,358443,126085,232358,0.6482,64.82
ITSmix-SB_74_S1066_R1_001.fastq.gz,352778,50750,302028,0.8561,85.61
ITSmix-SB_74_S1066_R2_001.fastq.gz,352778,129229,223549,0.6337,63.37
ITSmix-SB_75_S1067_R1_001.fastq.gz,384224,63765,320459,0.8340,83.40
ITSmix-SB_75_S1067_R2_001.fastq.gz,384224,134071,250153,0.6511,65.11
ITSmix-SB_76_S1068_R1_001.fastq.gz,475402,80524,394878,0.8306,83.06
ITSmix-SB_76_S1068_R2_001.fastq.gz,475402,156561,318841,0.6707,67.07
ITSmix-SB_77_S1069_R1_001.fastq.gz,532429,84762,447667,0.8408,84.08
ITSmix-SB_77_S1069_R2_001.fastq.gz,532429,189569,342860,0.6440,64.40
ITSmix-SB_78_S1070_R1_001.fastq.gz,360233,55397,304836,0.8462,84.62
ITSmix-SB_78_S1070_R2_001.fastq.gz,360233,110640,249593,0.6929,69.29
ITSmix-SB_7_S647_R1_001.fastq.gz,273953,54042,219911,0.8027,80.27
ITSmix-SB_7_S647_R2_001.fastq.gz,273953,102400,171553,0.6262,62.62
ITSmix-SB_80_S1072_R1_001.fastq.gz,537691,75631,462060,0.8593,85.93
ITSmix-SB_80_S1072_R2_001.fastq.gz,537691,201819,335872,0.6247,62.47
ITSmix-SB_81_S1073_R1_001.fastq.gz,194094,32797,161297,0.8310,83.10
ITSmix-SB_81_S1073_R2_001.fastq.gz,194094,101227,92867,0.4785,47.85
ITSmix-SB_82_S1074_R1_001.fastq.gz,264564,43809,220755,0.8344,83.44
ITSmix-SB_82_S1074_R2_001.fastq.gz,264564,93457,171107,0.6468,64.68
ITSmix-SB_83_S1075_R1_001.fastq.gz,154675,23328,131347,0.8492,84.92
ITSmix-SB_83_S1075_R2_001.fastq.gz,154675,60949,93726,0.6060,60.60
ITSmix-SB_84_S1076_R1_001.fastq.gz,315374,54492,260882,0.8272,82.72
ITSmix-SB_84_S1076_R2_001.fastq.gz,315374,142458,172916,0.5483,54.83
ITSmix-SB_85_S1077_R1_001.fastq.gz,208222,29796,178426,0.8569,85.69
ITSmix-SB_85_S1077_R2_001.fastq.gz,208222,77673,130549,0.6270,62.70
ITSmix-SB_86_S1078_R1_001.fastq.gz,323648,45329,278319,0.8599,85.99
ITSmix-SB_86_S1078_R2_001.fastq.gz,323648,119692,203956,0.6302,63.02
ITSmix-SB_87_S1079_R1_001.fastq.gz,320016,43790,276226,0.8632,86.32
ITSmix-SB_87_S1079_R2_001.fastq.gz,320016,131401,188615,0.5894,58.94
ITSmix-SB_88_S1080_R1_001.fastq.gz,340509,42315,298194,0.8757,87.57
ITSmix-SB_88_S1080_R2_001.fastq.gz,340509,125997,214512,0.6300,63.00
ITSmix-SB_89_S1081_R1_001.fastq.gz,368156,61066,307090,0.8341,83.41
ITSmix-SB_89_S1081_R2_001.fastq.gz,368156,121139,247017,0.6710,67.10
ITSmix-SB_8_S648_R1_001.fastq.gz,247380,41823,205557,0.8309,83.09
ITSmix-SB_8_S648_R2_001.fastq.gz,247380,83048,164332,0.6643,66.43
ITSmix-SB_90_S1082_R1_001.fastq.gz,389904,72639,317265,0.8137,81.37
ITSmix-SB_90_S1082_R2_001.fastq.gz,389904,130141,259763,0.6662,66.62
ITSmix-SB_91_S1083_R1_001.fastq.gz,165098,35434,129664,0.7854,78.54
ITSmix-SB_91_S1083_R2_001.fastq.gz,165098,59119,105979,0.6419,64.19
ITSmix-SB_92_S1084_R1_001.fastq.gz,258921,48481,210440,0.8128,81.28
ITSmix-SB_92_S1084_R2_001.fastq.gz,258921,92997,165924,0.6408,64.08
ITSmix-SB_93_S1085_R1_001.fastq.gz,281864,47457,234407,0.8316,83.16
ITSmix-SB_93_S1085_R2_001.fastq.gz,281864,83914,197950,0.7023,70.23
ITSmix-SB_94_S1086_R1_001.fastq.gz,312994,48734,264260,0.8443,84.43
ITSmix-SB_94_S1086_R2_001.fastq.gz,312994,101852,211142,0.6746,67.46
ITSmix-SB_95_S1087_R1_001.fastq.gz,359790,42258,317532,0.8825,88.25
ITSmix-SB_95_S1087_R2_001.fastq.gz,359790,123631,236159,0.6564,65.64
ITSmix-SB_96_S1088_R1_001.fastq.gz,553351,107677,445674,0.8054,80.54
ITSmix-SB_96_S1088_R2_001.fastq.gz,553351,176137,377214,0.6817,68.17
ITSmix-SB_97_S1089_R1_001.fastq.gz,252197,33093,219104,0.8688,86.88
ITSmix-SB_97_S1089_R2_001.fastq.gz,252197,78674,173523,0.6880,68.80
ITSmix-SB_98_S1090_R1_001.fastq.gz,266923,30793,236130,0.8846,88.46
ITSmix-SB_98_S1090_R2_001.fastq.gz,266923,82735,184188,0.6900,69.00
ITSmix-SB_99_S1091_R1_001.fastq.gz,219057,33264,185793,0.8481,84.81
ITSmix-SB_99_S1091_R2_001.fastq.gz,219057,67601,151456,0.6914,69.14
ITSmix-SB_9_S649_R1_001.fastq.gz,263487,44593,218894,0.8308,83.08
ITSmix-SB_9_S649_R2_001.fastq.gz,263487,72447,191040,0.7250,72.50
ITS-NL2_102_S194_R1_001.fastq.gz,310531,36733,273798,0.8817,88.17
ITS-NL2_102_S194_R2_001.fastq.gz,310531,109471,201060,0.6475,64.75
ITS-NL2_103_S195_R1_001.fastq.gz,232684,34185,198499,0.8531,85.31
ITS-NL2_103_S195_R2_001.fastq.gz,232684,85633,147051,0.6320,63.20
ITS-NL2_104_S196_R1_001.fastq.gz,262509,35571,226938,0.8645,86.45
ITS-NL2_104_S196_R2_001.fastq.gz,262509,93703,168806,0.6430,64.30
ITS-NL2_105_S197_R1_001.fastq.gz,304520,36295,268225,0.8808,88.08
ITS-NL2_105_S197_R2_001.fastq.gz,304520,101955,202565,0.6652,66.52
ITS-NL2_106_S198_R1_001.fastq.gz,394917,60615,334302,0.8465,84.65
ITS-NL2_106_S198_R2_001.fastq.gz,394917,135725,259192,0.6563,65.63
ITS-NL2_108_S200_R1_001.fastq.gz,428580,51241,377339,0.8804,88.04
ITS-NL2_108_S200_R2_001.fastq.gz,428580,160004,268576,0.6267,62.67
ITS-NL2_109_S201_R1_001.fastq.gz,142487,25110,117377,0.8238,82.38
ITS-NL2_109_S201_R2_001.fastq.gz,142487,55603,86884,0.6098,60.98
ITS-NL2_10_S687_R1_001.fastq.gz,420556,41297,379259,0.9018,90.18
ITS-NL2_10_S687_R2_001.fastq.gz,420556,153841,266715,0.6342,63.42
ITS-NL2_110_S202_R1_001.fastq.gz,284998,37071,247927,0.8699,86.99
ITS-NL2_110_S202_R2_001.fastq.gz,284998,111165,173833,0.6099,60.99
ITS-NL2_111_S203_R1_001.fastq.gz,256161,43089,213072,0.8318,83.18
ITS-NL2_111_S203_R2_001.fastq.gz,256161,93638,162523,0.6345,63.45
ITS-NL2_112_S204_R1_001.fastq.gz,247866,48642,199224,0.8038,80.38
ITS-NL2_112_S204_R2_001.fastq.gz,247866,109248,138618,0.5592,55.92
ITS-NL2_113_S205_R1_001.fastq.gz,243253,32070,211183,0.8682,86.82
ITS-NL2_113_S205_R2_001.fastq.gz,243253,99551,143702,0.5908,59.08
ITS-NL2_114_S206_R1_001.fastq.gz,208855,36123,172732,0.8270,82.70
ITS-NL2_114_S206_R2_001.fastq.gz,208855,142927,65928,0.3157,31.57
ITS-NL2_117_S209_R1_001.fastq.gz,262716,46769,215947,0.8220,82.20
ITS-NL2_117_S209_R2_001.fastq.gz,262716,105336,157380,0.5990,59.90
ITS-NL2_118_S210_R1_001.fastq.gz,13432,7178,6254,0.4656,46.56
ITS-NL2_118_S210_R2_001.fastq.gz,13432,9224,4208,0.3133,31.33
ITS-NL2_119_S211_R1_001.fastq.gz,479464,85297,394167,0.8221,82.21
ITS-NL2_119_S211_R2_001.fastq.gz,479464,180606,298858,0.6233,62.33
ITS-NL2_11_S686_R1_001.fastq.gz,209461,41833,167628,0.8003,80.03
ITS-NL2_11_S686_R2_001.fastq.gz,209461,84774,124687,0.5953,59.53
ITS-NL2_120_S212_R1_001.fastq.gz,413191,78432,334759,0.8102,81.02
ITS-NL2_120_S212_R2_001.fastq.gz,413191,175617,237574,0.5750,57.50
ITS-NL2_121_S213_R1_001.fastq.gz,13140,7075,6065,0.4616,46.16
ITS-NL2_121_S213_R2_001.fastq.gz,13140,8953,4187,0.3186,31.86
ITS-NL2_122_S214_R1_001.fastq.gz,257723,38715,219008,0.8498,84.98
ITS-NL2_122_S214_R2_001.fastq.gz,257723,96967,160756,0.6238,62.38
ITS-NL2_123_S215_R1_001.fastq.gz,14449,7605,6844,0.4737,47.37
ITS-NL2_123_S215_R2_001.fastq.gz,14449,9668,4781,0.3309,33.09
ITS-NL2_124_S216_R1_001.fastq.gz,584162,88377,495785,0.8487,84.87
ITS-NL2_124_S216_R2_001.fastq.gz,584162,219463,364699,0.6243,62.43
ITS-NL2_125_S217_R1_001.fastq.gz,168405,31124,137281,0.8152,81.52
ITS-NL2_125_S217_R2_001.fastq.gz,168405,68686,99719,0.5921,59.21
ITS-NL2_126_S218_R1_001.fastq.gz,9359,5288,4071,0.4350,43.50
ITS-NL2_126_S218_R2_001.fastq.gz,9359,6772,2587,0.2764,27.64
ITS-NL2_127_S219_R1_001.fastq.gz,10455,5948,4507,0.4311,43.11
ITS-NL2_127_S219_R2_001.fastq.gz,10455,7458,2997,0.2867,28.67
ITS-NL2_12_S685_R1_001.fastq.gz,409114,44835,364279,0.8904,89.04
ITS-NL2_12_S685_R2_001.fastq.gz,409114,159837,249277,0.6093,60.93
ITS-NL2_130_S222_R1_001.fastq.gz,182064,41978,140086,0.7694,76.94
ITS-NL2_130_S222_R2_001.fastq.gz,182064,87674,94390,0.5184,51.84
ITS-NL2_131_S223_R1_001.fastq.gz,10371,5827,4544,0.4381,43.81
ITS-NL2_131_S223_R2_001.fastq.gz,10371,7348,3023,0.2915,29.15
ITS-NL2_132_S224_R1_001.fastq.gz,180940,33693,147247,0.8138,81.38
ITS-NL2_132_S224_R2_001.fastq.gz,180940,75913,105027,0.5805,58.05
ITS-NL2_133_S225_R1_001.fastq.gz,254677,38996,215681,0.8469,84.69
ITS-NL2_133_S225_R2_001.fastq.gz,254677,96043,158634,0.6229,62.29
ITS-NL2_135_S227_R1_001.fastq.gz,247566,38280,209286,0.8454,84.54
ITS-NL2_135_S227_R2_001.fastq.gz,247566,81964,165602,0.6689,66.89
ITS-NL2_136_S228_R1_001.fastq.gz,223398,39471,183927,0.8233,82.33
ITS-NL2_136_S228_R2_001.fastq.gz,223398,77061,146337,0.6551,65.51
ITS-NL2_137a_S229_R1_001.fastq.gz,359942,58455,301487,0.8376,83.76
ITS-NL2_137a_S229_R2_001.fastq.gz,359942,124177,235765,0.6550,65.50
ITS-NL2_137b_S230_R1_001.fastq.gz,18059,9846,8213,0.4548,45.48
ITS-NL2_137b_S230_R2_001.fastq.gz,18059,12524,5535,0.3065,30.65
ITS-NL2_138_S733_R1_001.fastq.gz,13449,7934,5515,0.4101,41.01
ITS-NL2_138_S733_R2_001.fastq.gz,13449,10182,3267,0.2429,24.29
ITS-NL2_13_S684_R1_001.fastq.gz,471706,92713,378993,0.8035,80.35
ITS-NL2_13_S684_R2_001.fastq.gz,471706,173921,297785,0.6313,63.13
ITS-NL2_140_S232_R1_001.fastq.gz,485552,64151,421401,0.8679,86.79
ITS-NL2_140_S232_R2_001.fastq.gz,485552,171159,314393,0.6475,64.75
ITS-NL2_142_S234_R1_001.fastq.gz,240524,40924,199600,0.8299,82.99
ITS-NL2_142_S234_R2_001.fastq.gz,240524,80930,159594,0.6635,66.35
ITS-NL2_143_S235_R1_001.fastq.gz,13113,7310,5803,0.4425,44.25
ITS-NL2_143_S235_R2_001.fastq.gz,13113,8746,4367,0.3330,33.30
ITS-NL2_144_S236_R1_001.fastq.gz,230453,53030,177423,0.7699,76.99
ITS-NL2_144_S236_R2_001.fastq.gz,230453,95924,134529,0.5838,58.38
ITS-NL2_146_S238_R1_001.fastq.gz,185498,45309,140189,0.7557,75.57
ITS-NL2_146_S238_R2_001.fastq.gz,185498,77773,107725,0.5807,58.07
ITS-NL2_147_S239_R1_001.fastq.gz,13369,7238,6131,0.4586,45.86
ITS-NL2_147_S239_R2_001.fastq.gz,13369,8954,4415,0.3302,33.02
ITS-NL2_148_S240_R1_001.fastq.gz,438424,61298,377126,0.8602,86.02
ITS-NL2_148_S240_R2_001.fastq.gz,438424,167823,270601,0.6172,61.72
ITS-NL2_149_S241_R1_001.fastq.gz,15101,8275,6826,0.4520,45.20
ITS-NL2_149_S241_R2_001.fastq.gz,15101,10016,5085,0.3367,33.67
ITS-NL2_14_S683_R1_001.fastq.gz,17544,9955,7589,0.4326,43.26
ITS-NL2_14_S683_R2_001.fastq.gz,17544,13045,4499,0.2564,25.64
ITS-NL2_150_S242_R1_001.fastq.gz,13181,7180,6001,0.4553,45.53
ITS-NL2_150_S242_R2_001.fastq.gz,13181,8778,4403,0.3340,33.40
ITS-NL2_152_S244_R1_001.fastq.gz,216502,51237,165265,0.7633,76.33
ITS-NL2_152_S244_R2_001.fastq.gz,216502,93910,122592,0.5662,56.62
ITS-NL2_153_S245_R1_001.fastq.gz,13331,7419,5912,0.4435,44.35
ITS-NL2_153_S245_R2_001.fastq.gz,13331,8976,4355,0.3267,32.67
ITS-NL2_155_S247_R1_001.fastq.gz,14476,7803,6673,0.4610,46.10
ITS-NL2_155_S247_R2_001.fastq.gz,14476,9537,4939,0.3412,34.12
ITS-NL2_157_S249_R1_001.fastq.gz,272427,38559,233868,0.8585,85.85
ITS-NL2_157_S249_R2_001.fastq.gz,272427,100294,172133,0.6319,63.19
ITS-NL2_158_S250_R1_001.fastq.gz,364682,38774,325908,0.8937,89.37
ITS-NL2_158_S250_R2_001.fastq.gz,364682,114221,250461,0.6868,68.68
ITS-NL2_159_S251_R1_001.fastq.gz,10477,5490,4987,0.4760,47.60
ITS-NL2_159_S251_R2_001.fastq.gz,10477,6685,3792,0.3619,36.19
ITS-NL2_15_S682_R1_001.fastq.gz,9930,5184,4746,0.4779,47.79
ITS-NL2_15_S682_R2_001.fastq.gz,9930,7392,2538,0.2556,25.56
ITS-NL2_160_S252_R1_001.fastq.gz,304714,51463,253251,0.8311,83.11
ITS-NL2_160_S252_R2_001.fastq.gz,304714,108605,196109,0.6436,64.36
ITS-NL2_161_S253_R1_001.fastq.gz,9325,5079,4246,0.4553,45.53
ITS-NL2_161_S253_R2_001.fastq.gz,9325,6310,3015,0.3233,32.33
ITS-NL2_162_S254_R1_001.fastq.gz,12392,6406,5986,0.4831,48.31
ITS-NL2_162_S254_R2_001.fastq.gz,12392,7986,4406,0.3556,35.56
ITS-NL2_163_S255_R1_001.fastq.gz,326931,46830,280101,0.8568,85.68
ITS-NL2_163_S255_R2_001.fastq.gz,326931,104541,222390,0.6802,68.02
ITS-NL2_164_S256_R1_001.fastq.gz,317971,45260,272711,0.8577,85.77
ITS-NL2_164_S256_R2_001.fastq.gz,317971,129860,188111,0.5916,59.16
ITS-NL2_165_S257_R1_001.fastq.gz,10741,5997,4744,0.4417,44.17
ITS-NL2_165_S257_R2_001.fastq.gz,10741,7427,3314,0.3085,30.85
ITS-NL2_166_S258_R1_001.fastq.gz,197814,33155,164659,0.8324,83.24
ITS-NL2_166_S258_R2_001.fastq.gz,197814,68477,129337,0.6538,65.38
ITS-NL2_167_S259_R1_001.fastq.gz,281456,36903,244553,0.8689,86.89
ITS-NL2_167_S259_R2_001.fastq.gz,281456,84829,196627,0.6986,69.86
ITS-NL2_168_S260_R1_001.fastq.gz,10686,6220,4466,0.4179,41.79
ITS-NL2_168_S260_R2_001.fastq.gz,10686,7564,3122,0.2922,29.22
ITS-NL2_169_S261_R1_001.fastq.gz,9304,5393,3911,0.4204,42.04
ITS-NL2_169_S261_R2_001.fastq.gz,9304,6535,2769,0.2976,29.76
ITS-NL2_16_S681_R1_001.fastq.gz,476396,73632,402764,0.8454,84.54
ITS-NL2_16_S681_R2_001.fastq.gz,476396,169731,306665,0.6437,64.37
ITS-NL2_170_S262_R1_001.fastq.gz,290256,43474,246782,0.8502,85.02
ITS-NL2_170_S262_R2_001.fastq.gz,290256,183157,107099,0.3690,36.90
ITS-NL2_171_S263_R1_001.fastq.gz,10115,5690,4425,0.4375,43.75
ITS-NL2_171_S263_R2_001.fastq.gz,10115,6968,3147,0.3111,31.11
ITS-NL2_172_S264_R1_001.fastq.gz,195099,31069,164030,0.8408,84.08
ITS-NL2_172_S264_R2_001.fastq.gz,195099,80354,114745,0.5881,58.81
ITS-NL2_173_S265_R1_001.fastq.gz,14205,7365,6840,0.4815,48.15
ITS-NL2_173_S265_R2_001.fastq.gz,14205,9048,5157,0.3630,36.30
ITS-NL2_176_S268_R1_001.fastq.gz,184107,31284,152823,0.8301,83.01
ITS-NL2_176_S268_R2_001.fastq.gz,184107,71035,113072,0.6142,61.42
ITS-NL2_177_S269_R1_001.fastq.gz,199077,46086,152991,0.7685,76.85
ITS-NL2_177_S269_R2_001.fastq.gz,199077,86682,112395,0.5646,56.46
ITS-NL2_178_S270_R1_001.fastq.gz,16413,8445,7968,0.4855,48.55
ITS-NL2_178_S270_R2_001.fastq.gz,16413,10353,6060,0.3692,36.92
ITS-NL2_17_S689_R1_001.fastq.gz,375507,159602,215905,0.5750,57.50
ITS-NL2_17_S689_R2_001.fastq.gz,375507,264942,110565,0.2944,29.44
ITS-NL2_180_S272_R1_001.fastq.gz,21277,10448,10829,0.5090,50.90
ITS-NL2_180_S272_R2_001.fastq.gz,21277,13621,7656,0.3598,35.98
ITS-NL2_181_S273_R1_001.fastq.gz,265498,45351,220147,0.8292,82.92
ITS-NL2_181_S273_R2_001.fastq.gz,265498,98117,167381,0.6304,63.04
ITS-NL2_182_S274_R1_001.fastq.gz,137544,25789,111755,0.8125,81.25
ITS-NL2_182_S274_R2_001.fastq.gz,137544,63226,74318,0.5403,54.03
ITS-NL2_183_S275_R1_001.fastq.gz,10891,6095,4796,0.4404,44.04
ITS-NL2_183_S275_R2_001.fastq.gz,10891,7533,3358,0.3083,30.83
ITS-NL2_184_S276_R1_001.fastq.gz,11140,6644,4496,0.4036,40.36
ITS-NL2_184_S276_R2_001.fastq.gz,11140,8192,2948,0.2646,26.46
ITS-NL2_185_S277_R1_001.fastq.gz,9808,5599,4209,0.4291,42.91
ITS-NL2_185_S277_R2_001.fastq.gz,9808,6998,2810,0.2865,28.65
ITS-NL2_187_S279_R1_001.fastq.gz,331638,47908,283730,0.8555,85.55
ITS-NL2_187_S279_R2_001.fastq.gz,331638,228967,102671,0.3096,30.96
ITS-NL2_188_S280_R1_001.fastq.gz,16596,8821,7775,0.4685,46.85
ITS-NL2_188_S280_R2_001.fastq.gz,16596,11901,4695,0.2829,28.29
ITS-NL2_189_S281_R1_001.fastq.gz,185869,37585,148284,0.7978,79.78
ITS-NL2_189_S281_R2_001.fastq.gz,185869,73928,111941,0.6023,60.23
ITS-NL2_190_S282_R1_001.fastq.gz,12337,6818,5519,0.4474,44.74
ITS-NL2_190_S282_R2_001.fastq.gz,12337,8535,3802,0.3082,30.82
ITS-NL2_191_S667_R1_001.fastq.gz,175339,39034,136305,0.7774,77.74
ITS-NL2_191_S667_R2_001.fastq.gz,175339,74919,100420,0.5727,57.27
ITS-NL2_192_S668_R1_001.fastq.gz,92077,31842,60235,0.6542,65.42
ITS-NL2_192_S668_R2_001.fastq.gz,92077,56013,36064,0.3917,39.17
ITS-NL2_193_S285_R1_001.fastq.gz,217093,54261,162832,0.7501,75.01
ITS-NL2_193_S285_R2_001.fastq.gz,217093,94621,122472,0.5641,56.41
ITS-NL2_194_S286_R1_001.fastq.gz,242703,47227,195476,0.8054,80.54
ITS-NL2_194_S286_R2_001.fastq.gz,242703,93124,149579,0.6163,61.63
ITS-NL2_195_S671_R1_001.fastq.gz,396879,67559,329320,0.8298,82.98
ITS-NL2_195_S671_R2_001.fastq.gz,396879,224824,172055,0.4335,43.35
ITS-NL2_196_S724_R1_001.fastq.gz,250198,82763,167435,0.6692,66.92
ITS-NL2_196_S724_R2_001.fastq.gz,250198,177900,72298,0.2890,28.90
ITS-NL2_197_S725_R1_001.fastq.gz,171269,30139,141130,0.8240,82.40
ITS-NL2_197_S725_R2_001.fastq.gz,171269,116858,54411,0.3177,31.77
ITS-NL2_198_S726_R1_001.fastq.gz,13674,7972,5702,0.4170,41.70
ITS-NL2_198_S726_R2_001.fastq.gz,13674,10562,3112,0.2276,22.76
ITS-NL2_199_S727_R1_001.fastq.gz,219306,32793,186513,0.8505,85.05
ITS-NL2_199_S727_R2_001.fastq.gz,219306,146382,72924,0.3325,33.25
ITS-NL2_19_S691_R1_001.fastq.gz,10683,6436,4247,0.3975,39.75
ITS-NL2_19_S691_R2_001.fastq.gz,10683,8467,2216,0.2074,20.74
ITS-NL2_1_S673_R1_001.fastq.gz,514343,66917,447426,0.8699,86.99
ITS-NL2_1_S673_R2_001.fastq.gz,514343,266630,247713,0.4816,48.16
ITS-NL2_200_S728_R1_001.fastq.gz,144270,28797,115473,0.8004,80.04
ITS-NL2_200_S728_R2_001.fastq.gz,144270,99130,45140,0.3129,31.29
ITS-NL2_201_S729_R1_001.fastq.gz,12298,6973,5325,0.4330,43.30
ITS-NL2_201_S729_R2_001.fastq.gz,12298,9070,3228,0.2625,26.25
ITS-NL2_202_S730_R1_001.fastq.gz,263445,48037,215408,0.8177,81.77
ITS-NL2_202_S730_R2_001.fastq.gz,263445,143901,119544,0.4538,45.38
ITS-NL2_203_S731_R1_001.fastq.gz,204462,31421,173041,0.8463,84.63
ITS-NL2_203_S731_R2_001.fastq.gz,204462,74953,129509,0.6334,63.34
ITS-NL2_204_S732_R1_001.fastq.gz,169352,34143,135209,0.7984,79.84
ITS-NL2_204_S732_R2_001.fastq.gz,169352,77113,92239,0.5447,54.47
ITS-NL2_20_S692_R1_001.fastq.gz,291419,47380,244039,0.8374,83.74
ITS-NL2_20_S692_R2_001.fastq.gz,291419,170176,121243,0.4160,41.60
ITS-NL2_21_S693_R1_001.fastq.gz,355955,67486,288469,0.8104,81.04
ITS-NL2_21_S693_R2_001.fastq.gz,355955,168100,187855,0.5277,52.77
ITS-NL2_22_S694_R1_001.fastq.gz,341991,59048,282943,0.8273,82.73
ITS-NL2_22_S694_R2_001.fastq.gz,341991,131112,210879,0.6166,61.66
ITS-NL2_23_S695_R1_001.fastq.gz,11598,6747,4851,0.4183,41.83
ITS-NL2_23_S695_R2_001.fastq.gz,11598,9230,2368,0.2042,20.42
ITS-NL2_24_S696_R1_001.fastq.gz,347833,51208,296625,0.8528,85.28
ITS-NL2_24_S696_R2_001.fastq.gz,347833,149467,198366,0.5703,57.03
ITS-NL2_25_S697_R1_001.fastq.gz,260796,29083,231713,0.8885,88.85
ITS-NL2_25_S697_R2_001.fastq.gz,260796,84006,176790,0.6779,67.79
ITS-NL2_26_S698_R1_001.fastq.gz,7036,4094,2942,0.4181,41.81
ITS-NL2_26_S698_R2_001.fastq.gz,7036,5468,1568,0.2229,22.29
ITS-NL2_27_S699_R1_001.fastq.gz,382722,61072,321650,0.8404,84.04
ITS-NL2_27_S699_R2_001.fastq.gz,382722,166396,216326,0.5652,56.52
ITS-NL2_28_S700_R1_001.fastq.gz,279105,69581,209524,0.7507,75.07
ITS-NL2_28_S700_R2_001.fastq.gz,279105,115574,163531,0.5859,58.59
ITS-NL2_29_S701_R1_001.fastq.gz,306302,62862,243440,0.7948,79.48
ITS-NL2_29_S701_R2_001.fastq.gz,306302,115679,190623,0.6223,62.23
ITS-NL2_2_S674_R1_001.fastq.gz,557831,99649,458182,0.8214,82.14
ITS-NL2_2_S674_R2_001.fastq.gz,557831,260819,297012,0.5324,53.24
ITS-NL2_30_S702_R1_001.fastq.gz,202265,34158,168107,0.8311,83.11
ITS-NL2_30_S702_R2_001.fastq.gz,202265,114744,87521,0.4327,43.27
ITS-NL2_31_S703_R1_001.fastq.gz,285381,32249,253132,0.8870,88.70
ITS-NL2_31_S703_R2_001.fastq.gz,285381,103898,181483,0.6359,63.59
ITS-NL2_32_S704_R1_001.fastq.gz,344454,66064,278390,0.8082,80.82
ITS-NL2_32_S704_R2_001.fastq.gz,344454,133912,210542,0.6112,61.12
ITS-NL2_33_S705_R1_001.fastq.gz,21422,10214,11208,0.5232,52.32
ITS-NL2_33_S705_R2_001.fastq.gz,21422,14555,6867,0.3206,32.06
ITS-NL2_34_S706_R1_001.fastq.gz,187578,28149,159429,0.8499,84.99
ITS-NL2_34_S706_R2_001.fastq.gz,187578,70408,117170,0.6246,62.46
ITS-NL2_35_S707_R1_001.fastq.gz,279801,36490,243311,0.8696,86.96
ITS-NL2_35_S707_R2_001.fastq.gz,279801,141870,137931,0.4930,49.30
ITS-NL2_36_S708_R1_001.fastq.gz,316694,133111,183583,0.5797,57.97
ITS-NL2_36_S708_R2_001.fastq.gz,316694,227049,89645,0.2831,28.31
ITS-NL2_37_S709_R1_001.fastq.gz,353480,44005,309475,0.8755,87.55
ITS-NL2_37_S709_R2_001.fastq.gz,353480,120444,233036,0.6593,65.93
ITS-NL2_38_S710_R1_001.fastq.gz,254991,50341,204650,0.8026,80.26
ITS-NL2_38_S710_R2_001.fastq.gz,254991,105032,149959,0.5881,58.81
ITS-NL2_39_S711_R1_001.fastq.gz,15295,8651,6644,0.4344,43.44
ITS-NL2_39_S711_R2_001.fastq.gz,15295,11490,3805,0.2488,24.88
ITS-NL2_3_S675_R1_001.fastq.gz,379221,48052,331169,0.8733,87.33
ITS-NL2_3_S675_R2_001.fastq.gz,379221,123728,255493,0.6737,67.37
ITS-NL2_40_S712_R1_001.fastq.gz,434434,45154,389280,0.8961,89.61
ITS-NL2_40_S712_R2_001.fastq.gz,434434,135774,298660,0.6875,68.75
ITS-NL2_41_S713_R1_001.fastq.gz,217940,32276,185664,0.8519,85.19
ITS-NL2_41_S713_R2_001.fastq.gz,217940,72482,145458,0.6674,66.74
ITS-NL2_42_S714_R1_001.fastq.gz,185465,22742,162723,0.8774,87.74
ITS-NL2_42_S714_R2_001.fastq.gz,185465,62504,122961,0.6630,66.30
ITS-NL2_43_S715_R1_001.fastq.gz,247150,26595,220555,0.8924,89.24
ITS-NL2_43_S715_R2_001.fastq.gz,247150,89721,157429,0.6370,63.70
ITS-NL2_44_S716_R1_001.fastq.gz,266362,117419,148943,0.5592,55.92
ITS-NL2_44_S716_R2_001.fastq.gz,266362,188114,78248,0.2938,29.38
ITS-NL2_45_S717_R1_001.fastq.gz,230942,31954,198988,0.8616,86.16
ITS-NL2_45_S717_R2_001.fastq.gz,230942,77846,153096,0.6629,66.29
ITS-NL2_46_S718_R1_001.fastq.gz,168935,96494,72441,0.4288,42.88
ITS-NL2_46_S718_R2_001.fastq.gz,168935,135542,33393,0.1977,19.77
ITS-NL2_47_S719_R1_001.fastq.gz,422509,238162,184347,0.4363,43.63
ITS-NL2_47_S719_R2_001.fastq.gz,422509,318756,103753,0.2456,24.56
ITS-NL2_48_S720_R1_001.fastq.gz,358199,42876,315323,0.8803,88.03
ITS-NL2_48_S720_R2_001.fastq.gz,358199,134071,224128,0.6257,62.57
ITS-NL2_49_S721_R1_001.fastq.gz,363474,71542,291932,0.8032,80.32
ITS-NL2_49_S721_R2_001.fastq.gz,363474,161143,202331,0.5567,55.67
ITS-NL2_4_S676_R1_001.fastq.gz,454736,61489,393247,0.8648,86.48
ITS-NL2_4_S676_R2_001.fastq.gz,454736,142019,312717,0.6877,68.77
ITS-NL2_50_S722_R1_001.fastq.gz,140792,19880,120912,0.8588,85.88
ITS-NL2_50_S722_R2_001.fastq.gz,140792,55623,85169,0.6049,60.49
ITS-NL2_51_S723_R1_001.fastq.gz,647632,87316,560316,0.8652,86.52
ITS-NL2_51_S723_R2_001.fastq.gz,647632,232204,415428,0.6415,64.15
ITS-NL2_5_S677_R1_001.fastq.gz,223851,36485,187366,0.8370,83.70
ITS-NL2_5_S677_R2_001.fastq.gz,223851,81913,141938,0.6341,63.41
ITS-NL2_6_S678_R1_001.fastq.gz,254305,47324,206981,0.8139,81.39
ITS-NL2_6_S678_R2_001.fastq.gz,254305,101427,152878,0.6012,60.12
ITS-NL2_7_S679_R1_001.fastq.gz,446380,88662,357718,0.8014,80.14
ITS-NL2_7_S679_R2_001.fastq.gz,446380,209821,236559,0.5299,52.99
ITS-NL2_9_S688_R1_001.fastq.gz,458744,69461,389283,0.8486,84.86
ITS-NL2_9_S688_R2_001.fastq.gz,458744,185197,273547,0.5963,59.63
ITS-SB_100_S1284_R1_001.fastq.gz,196696,24902,171794,0.8734,87.34
ITS-SB_100_S1284_R2_001.fastq.gz,196696,72968,123728,0.6290,62.90
ITS-SB_101_S1285_R1_001.fastq.gz,203972,25105,178867,0.8769,87.69
ITS-SB_101_S1285_R2_001.fastq.gz,203972,76679,127293,0.6241,62.41
ITS-SB_102_S1286_R1_001.fastq.gz,210726,25692,185034,0.8781,87.81
ITS-SB_102_S1286_R2_001.fastq.gz,210726,77620,133106,0.6317,63.17
ITS-SB_103_S1287_R1_001.fastq.gz,255696,44183,211513,0.8272,82.72
ITS-SB_103_S1287_R2_001.fastq.gz,255696,100137,155559,0.6084,60.84
ITS-SB_104_S1288_R1_001.fastq.gz,365184,54911,310273,0.8496,84.96
ITS-SB_104_S1288_R2_001.fastq.gz,365184,130417,234767,0.6429,64.29
ITS-SB_105_S1289_R1_001.fastq.gz,208206,21757,186449,0.8955,89.55
ITS-SB_105_S1289_R2_001.fastq.gz,208206,74495,133711,0.6422,64.22
ITS-SB_106_S1290_R1_001.fastq.gz,283542,25362,258180,0.9106,91.06
ITS-SB_106_S1290_R2_001.fastq.gz,283542,93176,190366,0.6714,67.14
ITS-SB_107_S1291_R1_001.fastq.gz,175916,23285,152631,0.8676,86.76
ITS-SB_107_S1291_R2_001.fastq.gz,175916,76246,99670,0.5666,56.66
ITS-SB_108_S1292_R1_001.fastq.gz,236185,38011,198174,0.8391,83.91
ITS-SB_108_S1292_R2_001.fastq.gz,236185,86844,149341,0.6323,63.23
ITS-SB_112_S1296_R1_001.fastq.gz,404993,33837,371156,0.9165,91.65
ITS-SB_112_S1296_R2_001.fastq.gz,404993,128768,276225,0.6820,68.20
ITS-SB_113_S1297_R1_001.fastq.gz,225410,23194,202216,0.8971,89.71
ITS-SB_113_S1297_R2_001.fastq.gz,225410,82296,143114,0.6349,63.49
ITS-SB_114_S1298_R1_001.fastq.gz,288102,27961,260141,0.9029,90.29
ITS-SB_114_S1298_R2_001.fastq.gz,288102,99892,188210,0.6533,65.33
ITS-SB_115_S1299_R1_001.fastq.gz,245621,39597,206024,0.8388,83.88
ITS-SB_115_S1299_R2_001.fastq.gz,245621,91765,153856,0.6264,62.64
ITS-SB_116_S1300_R1_001.fastq.gz,301197,53824,247373,0.8213,82.13
ITS-SB_116_S1300_R2_001.fastq.gz,301197,120374,180823,0.6003,60.03
ITS-SB_117_S1301_R1_001.fastq.gz,251990,26616,225374,0.8944,89.44
ITS-SB_117_S1301_R2_001.fastq.gz,251990,85901,166089,0.6591,65.91
ITS-SB_118_S1302_R1_001.fastq.gz,230386,25453,204933,0.8895,88.95
ITS-SB_118_S1302_R2_001.fastq.gz,230386,78863,151523,0.6577,65.77
ITS-SB_119_S1303_R1_001.fastq.gz,370406,56514,313892,0.8474,84.74
ITS-SB_119_S1303_R2_001.fastq.gz,370406,133045,237361,0.6408,64.08
ITS-SB_120_S1304_R1_001.fastq.gz,440675,63391,377284,0.8562,85.62
ITS-SB_120_S1304_R2_001.fastq.gz,440675,154984,285691,0.6483,64.83
ITS-SB_121_S1305_R1_001.fastq.gz,21747,8434,13313,0.6122,61.22
ITS-SB_121_S1305_R2_001.fastq.gz,21747,13147,8600,0.3955,39.55
ITS-SB_122_S1306_R1_001.fastq.gz,277743,25198,252545,0.9093,90.93
ITS-SB_122_S1306_R2_001.fastq.gz,277743,87589,190154,0.6846,68.46
ITS-SB_123_S1307_R1_001.fastq.gz,255279,39502,215777,0.8453,84.53
ITS-SB_123_S1307_R2_001.fastq.gz,255279,88953,166326,0.6515,65.15
ITS-SB_125_S1309_R1_001.fastq.gz,190106,22176,167930,0.8833,88.33
ITS-SB_125_S1309_R2_001.fastq.gz,190106,66039,124067,0.6526,65.26
ITS-SB_126_S1310_R1_001.fastq.gz,268559,36586,231973,0.8638,86.38
ITS-SB_126_S1310_R2_001.fastq.gz,268559,86807,181752,0.6768,67.68
ITS-SB_127_S1311_R1_001.fastq.gz,382612,50422,332190,0.8682,86.82
ITS-SB_127_S1311_R2_001.fastq.gz,382612,124805,257807,0.6738,67.38
ITS-SB_128_S1312_R1_001.fastq.gz,643081,95715,547366,0.8512,85.12
ITS-SB_128_S1312_R2_001.fastq.gz,643081,290056,353025,0.5490,54.90
ITS-SB_129_S1313_R1_001.fastq.gz,331244,55102,276142,0.8337,83.37
ITS-SB_129_S1313_R2_001.fastq.gz,331244,140687,190557,0.5753,57.53
ITS-SB_12_S748_R1_001.fastq.gz,346816,53850,292966,0.8447,84.47
ITS-SB_12_S748_R2_001.fastq.gz,346816,135407,211409,0.6096,60.96
ITS-SB_130_S1314_R1_001.fastq.gz,232849,27871,204978,0.8803,88.03
ITS-SB_130_S1314_R2_001.fastq.gz,232849,86920,145929,0.6267,62.67
ITS-SB_131_S1315_R1_001.fastq.gz,230605,24978,205627,0.8917,89.17
ITS-SB_131_S1315_R2_001.fastq.gz,230605,83326,147279,0.6387,63.87
ITS-SB_132_S1316_R1_001.fastq.gz,273497,48547,224950,0.8225,82.25
ITS-SB_132_S1316_R2_001.fastq.gz,273497,104233,169264,0.6189,61.89
ITS-SB_133_S1317_R1_001.fastq.gz,249021,27155,221866,0.8910,89.10
ITS-SB_133_S1317_R2_001.fastq.gz,249021,91224,157797,0.6337,63.37
ITS-SB_134_S1318_R1_001.fastq.gz,237937,26181,211756,0.8900,89.00
ITS-SB_134_S1318_R2_001.fastq.gz,237937,85617,152320,0.6402,64.02
ITS-SB_137_S1321_R1_001.fastq.gz,296738,59115,237623,0.8008,80.08
ITS-SB_137_S1321_R2_001.fastq.gz,296738,140924,155814,0.5251,52.51
ITS-SB_138_S1322_R1_001.fastq.gz,218318,24282,194036,0.8888,88.88
ITS-SB_138_S1322_R2_001.fastq.gz,218318,73899,144419,0.6615,66.15
ITS-SB_139_S1323_R1_001.fastq.gz,234391,38401,195990,0.8362,83.62
ITS-SB_139_S1323_R2_001.fastq.gz,234391,83262,151129,0.6448,64.48
ITS-SB_13_S749_R1_001.fastq.gz,410456,196915,213541,0.5203,52.03
ITS-SB_13_S749_R2_001.fastq.gz,410456,308248,102208,0.2490,24.90
ITS-SB_140_S1324_R1_001.fastq.gz,253666,43509,210157,0.8285,82.85
ITS-SB_140_S1324_R2_001.fastq.gz,253666,90485,163181,0.6433,64.33
ITS-SB_141_S1325_R1_001.fastq.gz,242785,27014,215771,0.8887,88.87
ITS-SB_141_S1325_R2_001.fastq.gz,242785,86178,156607,0.6450,64.50
ITS-SB_142_S1326_R1_001.fastq.gz,197760,23684,174076,0.8802,88.02
ITS-SB_142_S1326_R2_001.fastq.gz,197760,70489,127271,0.6436,64.36
ITS-SB_143_S1327_R1_001.fastq.gz,347042,34315,312727,0.9011,90.11
ITS-SB_143_S1327_R2_001.fastq.gz,347042,117835,229207,0.6605,66.05
ITS-SB_144_S1328_R1_001.fastq.gz,317618,35151,282467,0.8893,88.93
ITS-SB_144_S1328_R2_001.fastq.gz,317618,108932,208686,0.6570,65.70
ITS-SB_145_S1330_R1_001.fastq.gz,214092,22009,192083,0.8972,89.72
ITS-SB_145_S1330_R2_001.fastq.gz,214092,76449,137643,0.6429,64.29
ITS-SB_148_S1332_R1_001.fastq.gz,263842,43547,220295,0.8350,83.50
ITS-SB_148_S1332_R2_001.fastq.gz,263842,92813,171029,0.6482,64.82
ITS-SB_149_S1333_R1_001.fastq.gz,278943,28388,250555,0.8982,89.82
ITS-SB_149_S1333_R2_001.fastq.gz,278943,93285,185658,0.6656,66.56
ITS-SB_14_S750_R1_001.fastq.gz,288757,30922,257835,0.8929,89.29
ITS-SB_14_S750_R2_001.fastq.gz,288757,91564,197193,0.6829,68.29
ITS-SB_150_S1334_R1_001.fastq.gz,308074,27765,280309,0.9099,90.99
ITS-SB_150_S1334_R2_001.fastq.gz,308074,96899,211175,0.6855,68.55
ITS-SB_151_S1335_R1_001.fastq.gz,448568,44812,403756,0.9001,90.01
ITS-SB_151_S1335_R2_001.fastq.gz,448568,153300,295268,0.6582,65.82
ITS-SB_152_S1336_R1_001.fastq.gz,328371,31481,296890,0.9041,90.41
ITS-SB_152_S1336_R2_001.fastq.gz,328371,106191,222180,0.6766,67.66
ITS-SB_153_S1337_R1_001.fastq.gz,256959,52254,204705,0.7966,79.66
ITS-SB_153_S1337_R2_001.fastq.gz,256959,148550,108409,0.4219,42.19
ITS-SB_154_S1338_R1_001.fastq.gz,224921,38820,186101,0.8274,82.74
ITS-SB_154_S1338_R2_001.fastq.gz,224921,100268,124653,0.5542,55.42
ITS-SB_155_S1339_R1_001.fastq.gz,119565,18165,101400,0.8481,84.81
ITS-SB_155_S1339_R2_001.fastq.gz,119565,48858,70707,0.5914,59.14
ITS-SB_156_S1340_R1_001.fastq.gz,154179,22027,132152,0.8571,85.71
ITS-SB_156_S1340_R2_001.fastq.gz,154179,67231,86948,0.5639,56.39
ITS-SB_158_S1342_R1_001.fastq.gz,17985,9608,8377,0.4658,46.58
ITS-SB_158_S1342_R2_001.fastq.gz,17985,12685,5300,0.2947,29.47
ITS-SB_15_S751_R1_001.fastq.gz,422955,57821,365134,0.8633,86.33
ITS-SB_15_S751_R2_001.fastq.gz,422955,153651,269304,0.6367,63.67
ITS-SB_161_S735_R1_001.fastq.gz,10877,6476,4401,0.4046,40.46
ITS-SB_161_S735_R2_001.fastq.gz,10877,8252,2625,0.2413,24.13
ITS-SB_162_S736_R1_001.fastq.gz,157882,21320,136562,0.8650,86.50
ITS-SB_162_S736_R2_001.fastq.gz,157882,62237,95645,0.6058,60.58
ITS-SB_17_S753_R1_001.fastq.gz,182819,26077,156742,0.8574,85.74
ITS-SB_17_S753_R2_001.fastq.gz,182819,82536,100283,0.5485,54.85
ITS-SB_18_S754_R1_001.fastq.gz,188349,22995,165354,0.8779,87.79
ITS-SB_18_S754_R2_001.fastq.gz,188349,87692,100657,0.5344,53.44
ITS-SB_19_S755_R1_001.fastq.gz,230487,50846,179641,0.7794,77.94
ITS-SB_19_S755_R2_001.fastq.gz,230487,135005,95482,0.4143,41.43
ITS-SB_1_S737_R1_001.fastq.gz,354452,51720,302732,0.8541,85.41
ITS-SB_1_S737_R2_001.fastq.gz,354452,129204,225248,0.6355,63.55
ITS-SB_21_S757_R1_001.fastq.gz,199102,32496,166606,0.8368,83.68
ITS-SB_21_S757_R2_001.fastq.gz,199102,94259,104843,0.5266,52.66
ITS-SB_22_S758_R1_001.fastq.gz,247441,23929,223512,0.9033,90.33
ITS-SB_22_S758_R2_001.fastq.gz,247441,120237,127204,0.5141,51.41
ITS-SB_23_S759_R1_001.fastq.gz,315585,45254,270331,0.8566,85.66
ITS-SB_23_S759_R2_001.fastq.gz,315585,119368,196217,0.6218,62.18
ITS-SB_24_S760_R1_001.fastq.gz,302841,55512,247329,0.8167,81.67
ITS-SB_24_S760_R2_001.fastq.gz,302841,134120,168721,0.5571,55.71
ITS-SB_25_S761_R1_001.fastq.gz,280753,63838,216915,0.7726,77.26
ITS-SB_25_S761_R2_001.fastq.gz,280753,155528,125225,0.4460,44.60
ITS-SB_26_S762_R1_001.fastq.gz,206307,95544,110763,0.5369,53.69
ITS-SB_26_S762_R2_001.fastq.gz,206307,154433,51874,0.2514,25.14
ITS-SB_27_S763_R1_001.fastq.gz,162605,35563,127042,0.7813,78.13
ITS-SB_27_S763_R2_001.fastq.gz,162605,71950,90655,0.5575,55.75
ITS-SB_28_S764_R1_001.fastq.gz,154733,19275,135458,0.8754,87.54
ITS-SB_28_S764_R2_001.fastq.gz,154733,60921,93812,0.6063,60.63
ITS-SB_29_S765_R1_001.fastq.gz,258989,31977,227012,0.8765,87.65
ITS-SB_29_S765_R2_001.fastq.gz,258989,106199,152790,0.5899,58.99
ITS-SB_2_S738_R1_001.fastq.gz,165311,26239,139072,0.8413,84.13
ITS-SB_2_S738_R2_001.fastq.gz,165311,75803,89508,0.5415,54.15
ITS-SB_31_S767_R1_001.fastq.gz,161067,24700,136367,0.8466,84.66
ITS-SB_31_S767_R2_001.fastq.gz,161067,52100,108967,0.6765,67.65
ITS-SB_3_S739_R1_001.fastq.gz,296075,145233,150842,0.5095,50.95
ITS-SB_3_S739_R2_001.fastq.gz,296075,232861,63214,0.2135,21.35
ITS-SB_4_S740_R1_001.fastq.gz,144836,17957,126879,0.8760,87.60
ITS-SB_4_S740_R2_001.fastq.gz,144836,65249,79587,0.5495,54.95
ITS-SB_5_S741_R1_001.fastq.gz,185112,37960,147152,0.7949,79.49
ITS-SB_5_S741_R2_001.fastq.gz,185112,75960,109152,0.5897,58.97
ITS-SB_65_S1249_R1_001.fastq.gz,17199,9009,8190,0.4762,47.62
ITS-SB_65_S1249_R2_001.fastq.gz,17199,11944,5255,0.3055,30.55
ITS-SB_66_S1250_R1_001.fastq.gz,197750,25264,172486,0.8722,87.22
ITS-SB_66_S1250_R2_001.fastq.gz,197750,85043,112707,0.5699,56.99
ITS-SB_67_S1251_R1_001.fastq.gz,315355,45727,269628,0.8550,85.50
ITS-SB_67_S1251_R2_001.fastq.gz,315355,125143,190212,0.6032,60.32
ITS-SB_68_S1252_R1_001.fastq.gz,229697,38134,191563,0.8340,83.40
ITS-SB_68_S1252_R2_001.fastq.gz,229697,84878,144819,0.6305,63.05
ITS-SB_69_S1253_R1_001.fastq.gz,279123,29292,249831,0.8951,89.51
ITS-SB_69_S1253_R2_001.fastq.gz,279123,96490,182633,0.6543,65.43
ITS-SB_6_S742_R1_001.fastq.gz,196998,38575,158423,0.8042,80.42
ITS-SB_6_S742_R2_001.fastq.gz,196998,74528,122470,0.6217,62.17
ITS-SB_70_S1254_R1_001.fastq.gz,212084,29355,182729,0.8616,86.16
ITS-SB_70_S1254_R2_001.fastq.gz,212084,90595,121489,0.5728,57.28
ITS-SB_71_S1255_R1_001.fastq.gz,261759,31119,230640,0.8811,88.11
ITS-SB_71_S1255_R2_001.fastq.gz,261759,95236,166523,0.6362,63.62
ITS-SB_72_S1256_R1_001.fastq.gz,25312,12911,12401,0.4899,48.99
ITS-SB_72_S1256_R2_001.fastq.gz,25312,17310,8002,0.3161,31.61
ITS-SB_74_S1258_R1_001.fastq.gz,200597,21444,179153,0.8931,89.31
ITS-SB_74_S1258_R2_001.fastq.gz,200597,69032,131565,0.6559,65.59
ITS-SB_75_S1259_R1_001.fastq.gz,179164,26711,152453,0.8509,85.09
ITS-SB_75_S1259_R2_001.fastq.gz,179164,62891,116273,0.6490,64.90
ITS-SB_77_S1261_R1_001.fastq.gz,197197,30128,167069,0.8472,84.72
ITS-SB_77_S1261_R2_001.fastq.gz,197197,68743,128454,0.6514,65.14
ITS-SB_78_S1262_R1_001.fastq.gz,273689,44070,229619,0.8390,83.90
ITS-SB_78_S1262_R2_001.fastq.gz,273689,108127,165562,0.6049,60.49
ITS-SB_79_S1263_R1_001.fastq.gz,277179,41836,235343,0.8491,84.91
ITS-SB_79_S1263_R2_001.fastq.gz,277179,93744,183435,0.6618,66.18
ITS-SB_7_S743_R1_001.fastq.gz,348536,44650,303886,0.8719,87.19
ITS-SB_7_S743_R2_001.fastq.gz,348536,110456,238080,0.6831,68.31
ITS-SB_80_S1264_R1_001.fastq.gz,324397,31286,293111,0.9036,90.36
ITS-SB_80_S1264_R2_001.fastq.gz,324397,106102,218295,0.6729,67.29
ITS-SB_81_S1265_R1_001.fastq.gz,221066,22497,198569,0.8982,89.82
ITS-SB_81_S1265_R2_001.fastq.gz,221066,79944,141122,0.6384,63.84
ITS-SB_82_S1266_R1_001.fastq.gz,11432,5975,5457,0.4773,47.73
ITS-SB_82_S1266_R2_001.fastq.gz,11432,8021,3411,0.2984,29.84
ITS-SB_83_S1267_R1_001.fastq.gz,138335,16483,121852,0.8808,88.08
ITS-SB_83_S1267_R2_001.fastq.gz,138335,51225,87110,0.6297,62.97
ITS-SB_86_S1270_R1_001.fastq.gz,143542,18374,125168,0.8720,87.20
ITS-SB_86_S1270_R2_001.fastq.gz,143542,52188,91354,0.6364,63.64
ITS-SB_87_S1271_R1_001.fastq.gz,271008,27504,243504,0.8985,89.85
ITS-SB_87_S1271_R2_001.fastq.gz,271008,87007,184001,0.6790,67.90
ITS-SB_89_S1273_R1_001.fastq.gz,16649,8705,7944,0.4771,47.71
ITS-SB_89_S1273_R2_001.fastq.gz,16649,11566,5083,0.3053,30.53
ITS-SB_8_S744_R1_001.fastq.gz,196918,22857,174061,0.8839,88.39
ITS-SB_8_S744_R2_001.fastq.gz,196918,84381,112537,0.5715,57.15
ITS-SB_90_S1274_R1_001.fastq.gz,279252,38476,240776,0.8622,86.22
ITS-SB_90_S1274_R2_001.fastq.gz,279252,110016,169236,0.6060,60.60
ITS-SB_91_S1275_R1_001.fastq.gz,242100,50813,191287,0.7901,79.01
ITS-SB_91_S1275_R2_001.fastq.gz,242100,96047,146053,0.6033,60.33
ITS-SB_92_S1276_R1_001.fastq.gz,271672,43400,228272,0.8402,84.02
ITS-SB_92_S1276_R2_001.fastq.gz,271672,100459,171213,0.6302,63.02
ITS-SB_93_S1277_R1_001.fastq.gz,413480,56314,357166,0.8638,86.38
ITS-SB_93_S1277_R2_001.fastq.gz,413480,126989,286491,0.6929,69.29
ITS-SB_94_S1278_R1_001.fastq.gz,283851,29968,253883,0.8944,89.44
ITS-SB_94_S1278_R2_001.fastq.gz,283851,92798,191053,0.6731,67.31
ITS-SB_96_S1280_R1_001.fastq.gz,415542,82496,333046,0.8015,80.15
ITS-SB_96_S1280_R2_001.fastq.gz,415542,155793,259749,0.6251,62.51
ITS-SB_97_S1281_R1_001.fastq.gz,209088,22798,186290,0.8910,89.10
ITS-SB_97_S1281_R2_001.fastq.gz,209088,77680,131408,0.6285,62.85
ITS-SB_9_S745_R1_001.fastq.gz,272318,37129,235189,0.8637,86.37
ITS-SB_9_S745_R2_001.fastq.gz,272318,86235,186083,0.6833,68.33
LSU-Blank1_S576_R1_001.fastq.gz,1184901,194679,990222,0.8357,83.57
LSU-Blank1_S576_R2_001.fastq.gz,1184901,458831,726070,0.6128,61.28
LSU-Blank2_S1056_R1_001.fastq.gz,58639,20979,37660,0.6422,64.22
LSU-Blank2_S1056_R2_001.fastq.gz,58639,33054,25585,0.4363,43.63
LSU-Blank3_S1440_R1_001.fastq.gz,22672,11554,11118,0.4904,49.04
LSU-Blank3_S1440_R2_001.fastq.gz,22672,15160,7512,0.3313,33.13
LSU-NL2_102_S482_R1_001.fastq.gz,352000,82432,269568,0.7658,76.58
LSU-NL2_102_S482_R2_001.fastq.gz,352000,180078,171922,0.4884,48.84
LSU-NL2_103_S483_R1_001.fastq.gz,296116,73365,222751,0.7522,75.22
LSU-NL2_103_S483_R2_001.fastq.gz,296116,140523,155593,0.5254,52.54
LSU-NL2_104_S484_R1_001.fastq.gz,354626,80763,273863,0.7723,77.23
LSU-NL2_104_S484_R2_001.fastq.gz,354626,159911,194715,0.5491,54.91
LSU-NL2_105_S485_R1_001.fastq.gz,359271,76491,282780,0.7871,78.71
LSU-NL2_105_S485_R2_001.fastq.gz,359271,159993,199278,0.5547,55.47
LSU-NL2_108_S488_R1_001.fastq.gz,595473,120382,475091,0.7978,79.78
LSU-NL2_108_S488_R2_001.fastq.gz,595473,246985,348488,0.5852,58.52
LSU-NL2_109_S489_R1_001.fastq.gz,179489,28156,151333,0.8431,84.31
LSU-NL2_109_S489_R2_001.fastq.gz,179489,61786,117703,0.6558,65.58
LSU-NL2_10_S970_R1_001.fastq.gz,233689,36850,196839,0.8423,84.23
LSU-NL2_10_S970_R2_001.fastq.gz,233689,84202,149487,0.6397,63.97
LSU-NL2_111_S491_R1_001.fastq.gz,10297,6435,3862,0.3751,37.51
LSU-NL2_111_S491_R2_001.fastq.gz,10297,7946,2351,0.2283,22.83
LSU-NL2_112_S492_R1_001.fastq.gz,302080,57396,244684,0.8100,81.00
LSU-NL2_112_S492_R2_001.fastq.gz,302080,126971,175109,0.5797,57.97
LSU-NL2_113_S493_R1_001.fastq.gz,309723,75250,234473,0.7570,75.70
LSU-NL2_113_S493_R2_001.fastq.gz,309723,149283,160440,0.5180,51.80
LSU-NL2_117_S497_R1_001.fastq.gz,28589,11802,16787,0.5872,58.72
LSU-NL2_117_S497_R2_001.fastq.gz,28589,17910,10679,0.3735,37.35
LSU-NL2_118_S498_R1_001.fastq.gz,6142,3481,2661,0.4332,43.32
LSU-NL2_118_S498_R2_001.fastq.gz,6142,4718,1424,0.2318,23.18
LSU-NL2_11_S971_R1_001.fastq.gz,186930,22975,163955,0.8771,87.71
LSU-NL2_11_S971_R2_001.fastq.gz,186930,58195,128735,0.6887,68.87
LSU-NL2_120_S500_R1_001.fastq.gz,14873,8596,6277,0.4220,42.20
LSU-NL2_120_S500_R2_001.fastq.gz,14873,11160,3713,0.2496,24.96
LSU-NL2_121_S501_R1_001.fastq.gz,14577,8552,6025,0.4133,41.33
LSU-NL2_121_S501_R2_001.fastq.gz,14577,10994,3583,0.2458,24.58
LSU-NL2_122_S502_R1_001.fastq.gz,304174,57553,246621,0.8108,81.08
LSU-NL2_122_S502_R2_001.fastq.gz,304174,123519,180655,0.5939,59.39
LSU-NL2_123_S503_R1_001.fastq.gz,12154,7137,5017,0.4128,41.28
LSU-NL2_123_S503_R2_001.fastq.gz,12154,9199,2955,0.2431,24.31
LSU-NL2_124_S504_R1_001.fastq.gz,425542,45185,380357,0.8938,89.38
LSU-NL2_124_S504_R2_001.fastq.gz,425542,102185,323357,0.7599,75.99
LSU-NL2_125_S505_R1_001.fastq.gz,382473,63007,319466,0.8353,83.53
LSU-NL2_125_S505_R2_001.fastq.gz,382473,134559,247914,0.6482,64.82
LSU-NL2_127_S507_R1_001.fastq.gz,14484,8713,5771,0.3984,39.84
LSU-NL2_127_S507_R2_001.fastq.gz,14484,10988,3496,0.2414,24.14
LSU-NL2_12_S972_R1_001.fastq.gz,286280,45040,241240,0.8427,84.27
LSU-NL2_12_S972_R2_001.fastq.gz,286280,107739,178541,0.6237,62.37
LSU-NL2_131_S511_R1_001.fastq.gz,15752,9151,6601,0.4191,41.91
LSU-NL2_131_S511_R2_001.fastq.gz,15752,11882,3870,0.2457,24.57
LSU-NL2_133_S513_R1_001.fastq.gz,324909,75310,249599,0.7682,76.82
LSU-NL2_133_S513_R2_001.fastq.gz,324909,147502,177407,0.5460,54.60
LSU-NL2_135_S515_R1_001.fastq.gz,15016,8853,6163,0.4104,41.04
LSU-NL2_135_S515_R2_001.fastq.gz,15016,11415,3601,0.2398,23.98
LSU-NL2_136_S516_R1_001.fastq.gz,21340,11675,9665,0.4529,45.29
LSU-NL2_136_S516_R2_001.fastq.gz,21340,15697,5643,0.2644,26.44
LSU-NL2_137a_S517_R1_001.fastq.gz,322984,34282,288702,0.8939,89.39
LSU-NL2_137a_S517_R2_001.fastq.gz,322984,77658,245326,0.7596,75.96
LSU-NL2_137b_S518_R1_001.fastq.gz,16299,9361,6938,0.4257,42.57
LSU-NL2_137b_S518_R2_001.fastq.gz,16299,12177,4122,0.2529,25.29
LSU-NL2_138_S1021_R1_001.fastq.gz,177579,21382,156197,0.8796,87.96
LSU-NL2_138_S1021_R2_001.fastq.gz,177579,48518,129061,0.7268,72.68
LSU-NL2_13_S973_R1_001.fastq.gz,286669,45858,240811,0.8400,84.00
LSU-NL2_13_S973_R2_001.fastq.gz,286669,105554,181115,0.6318,63.18
LSU-NL2_140_S520_R1_001.fastq.gz,552320,119825,432495,0.7831,78.31
LSU-NL2_140_S520_R2_001.fastq.gz,552320,216002,336318,0.6089,60.89
LSU-NL2_142_S522_R1_001.fastq.gz,279606,32278,247328,0.8846,88.46
LSU-NL2_142_S522_R2_001.fastq.gz,279606,76901,202705,0.7250,72.50
LSU-NL2_143_S523_R1_001.fastq.gz,12919,7731,5188,0.4016,40.16
LSU-NL2_143_S523_R2_001.fastq.gz,12919,9795,3124,0.2418,24.18
LSU-NL2_144_S524_R1_001.fastq.gz,261814,64035,197779,0.7554,75.54
LSU-NL2_144_S524_R2_001.fastq.gz,261814,126456,135358,0.5170,51.70
LSU-NL2_146_S526_R1_001.fastq.gz,333740,75228,258512,0.7746,77.46
LSU-NL2_146_S526_R2_001.fastq.gz,333740,154657,179083,0.5366,53.66
LSU-NL2_147_S527_R1_001.fastq.gz,14170,8295,5875,0.4146,41.46
LSU-NL2_147_S527_R2_001.fastq.gz,14170,10701,3469,0.2448,24.48
LSU-NL2_148_S528_R1_001.fastq.gz,521127,105415,415712,0.7977,79.77
LSU-NL2_148_S528_R2_001.fastq.gz,521127,219424,301703,0.5789,57.89
LSU-NL2_149_S529_R1_001.fastq.gz,15809,8872,6937,0.4388,43.88
LSU-NL2_149_S529_R2_001.fastq.gz,15809,11644,4165,0.2635,26.35
LSU-NL2_14_S974_R1_001.fastq.gz,15488,8933,6555,0.4232,42.32
LSU-NL2_14_S974_R2_001.fastq.gz,15488,10943,4545,0.2935,29.35
LSU-NL2_150_S530_R1_001.fastq.gz,7829,4263,3566,0.4555,45.55
LSU-NL2_150_S530_R2_001.fastq.gz,7829,5879,1950,0.2491,24.91
LSU-NL2_152_S532_R1_001.fastq.gz,354255,79994,274261,0.7742,77.42
LSU-NL2_152_S532_R2_001.fastq.gz,354255,152682,201573,0.5690,56.90
LSU-NL2_153_S533_R1_001.fastq.gz,260488,79845,180643,0.6935,69.35
LSU-NL2_153_S533_R2_001.fastq.gz,260488,137456,123032,0.4723,47.23
LSU-NL2_155_S535_R1_001.fastq.gz,14245,8311,5934,0.4166,41.66
LSU-NL2_155_S535_R2_001.fastq.gz,14245,10830,3415,0.2397,23.97
LSU-NL2_158_S538_R1_001.fastq.gz,359232,37089,322143,0.8968,89.68
LSU-NL2_158_S538_R2_001.fastq.gz,359232,96718,262514,0.7308,73.08
LSU-NL2_15_S975_R1_001.fastq.gz,13636,8071,5565,0.4081,40.81
LSU-NL2_15_S975_R2_001.fastq.gz,13636,10054,3582,0.2627,26.27
LSU-NL2_160_S540_R1_001.fastq.gz,271278,61866,209412,0.7719,77.19
LSU-NL2_160_S540_R2_001.fastq.gz,271278,118705,152573,0.5624,56.24
LSU-NL2_161_S541_R1_001.fastq.gz,16186,9596,6590,0.4071,40.71
LSU-NL2_161_S541_R2_001.fastq.gz,16186,12159,4027,0.2488,24.88
LSU-NL2_162_S542_R1_001.fastq.gz,13121,7915,5206,0.3968,39.68
LSU-NL2_162_S542_R2_001.fastq.gz,13121,10125,2996,0.2283,22.83
LSU-NL2_163_S543_R1_001.fastq.gz,455687,59875,395812,0.8686,86.86
LSU-NL2_163_S543_R2_001.fastq.gz,455687,138720,316967,0.6956,69.56
LSU-NL2_164_S544_R1_001.fastq.gz,466792,120880,345912,0.7410,74.10
LSU-NL2_164_S544_R2_001.fastq.gz,466792,232304,234488,0.5023,50.23
LSU-NL2_166_S546_R1_001.fastq.gz,156140,14781,141359,0.9053,90.53
LSU-NL2_166_S546_R2_001.fastq.gz,156140,38041,118099,0.7564,75.64
LSU-NL2_167_S547_R1_001.fastq.gz,343745,46742,297003,0.8640,86.40
LSU-NL2_167_S547_R2_001.fastq.gz,343745,114414,229331,0.6672,66.72
LSU-NL2_169_S549_R1_001.fastq.gz,19219,11504,7715,0.4014,40.14
LSU-NL2_169_S549_R2_001.fastq.gz,19219,14643,4576,0.2381,23.81
LSU-NL2_16_S976_R1_001.fastq.gz,353610,68568,285042,0.8061,80.61
LSU-NL2_16_S976_R2_001.fastq.gz,353610,153547,200063,0.5658,56.58
LSU-NL2_171_S551_R1_001.fastq.gz,15318,9084,6234,0.4070,40.70
LSU-NL2_171_S551_R2_001.fastq.gz,15318,11747,3571,0.2331,23.31
LSU-NL2_172_S552_R1_001.fastq.gz,337736,60082,277654,0.8221,82.21
LSU-NL2_172_S552_R2_001.fastq.gz,337736,127499,210237,0.6225,62.25
LSU-NL2_173_S553_R1_001.fastq.gz,18173,10372,7801,0.4293,42.93
LSU-NL2_173_S553_R2_001.fastq.gz,18173,13315,4858,0.2673,26.73
LSU-NL2_177_S557_R1_001.fastq.gz,242957,60599,182358,0.7506,75.06
LSU-NL2_177_S557_R2_001.fastq.gz,242957,113218,129739,0.5340,53.40
LSU-NL2_17_S977_R1_001.fastq.gz,257955,48736,209219,0.8111,81.11
LSU-NL2_17_S977_R2_001.fastq.gz,257955,101950,156005,0.6048,60.48
LSU-NL2_180_S560_R1_001.fastq.gz,24547,14016,10531,0.4290,42.90
LSU-NL2_180_S560_R2_001.fastq.gz,24547,17976,6571,0.2677,26.77
LSU-NL2_182_S562_R1_001.fastq.gz,273369,60577,212792,0.7784,77.84
LSU-NL2_182_S562_R2_001.fastq.gz,273369,126757,146612,0.5363,53.63
LSU-NL2_183_S563_R1_001.fastq.gz,318876,44696,274180,0.8598,85.98
LSU-NL2_183_S563_R2_001.fastq.gz,318876,108113,210763,0.6610,66.10
LSU-NL2_184_S564_R1_001.fastq.gz,355202,43399,311803,0.8778,87.78
LSU-NL2_184_S564_R2_001.fastq.gz,355202,106338,248864,0.7006,70.06
LSU-NL2_185_S565_R1_001.fastq.gz,19384,10798,8586,0.4429,44.29
LSU-NL2_185_S565_R2_001.fastq.gz,19384,14347,5037,0.2599,25.99
LSU-NL2_187_S567_R1_001.fastq.gz,435990,65793,370197,0.8491,84.91
LSU-NL2_187_S567_R2_001.fastq.gz,435990,153547,282443,0.6478,64.78
LSU-NL2_188_S568_R1_001.fastq.gz,546181,45494,500687,0.9167,91.67
LSU-NL2_188_S568_R2_001.fastq.gz,546181,114439,431742,0.7905,79.05
LSU-NL2_189_S569_R1_001.fastq.gz,226081,50179,175902,0.7780,77.80
LSU-NL2_189_S569_R2_001.fastq.gz,226081,98564,127517,0.5640,56.40
LSU-NL2_18_S978_R1_001.fastq.gz,294843,46432,248411,0.8425,84.25
LSU-NL2_18_S978_R2_001.fastq.gz,294843,107712,187131,0.6347,63.47
LSU-NL2_190_S570_R1_001.fastq.gz,286061,27643,258418,0.9034,90.34
LSU-NL2_190_S570_R2_001.fastq.gz,286061,73682,212379,0.7424,74.24
LSU-NL2_191_S571_R1_001.fastq.gz,266001,55675,210326,0.7907,79.07
LSU-NL2_191_S571_R2_001.fastq.gz,266001,109525,156476,0.5883,58.83
LSU-NL2_192_S572_R1_001.fastq.gz,340504,74693,265811,0.7806,78.06
LSU-NL2_192_S572_R2_001.fastq.gz,340504,154472,186032,0.5463,54.63
LSU-NL2_193_S573_R1_001.fastq.gz,302542,58992,243550,0.8050,80.50
LSU-NL2_193_S573_R2_001.fastq.gz,302542,124987,177555,0.5869,58.69
LSU-NL2_195_S575_R1_001.fastq.gz,247751,55508,192243,0.7760,77.60
LSU-NL2_195_S575_R2_001.fastq.gz,247751,113358,134393,0.5425,54.25
LSU-NL2_196_S1012_R1_001.fastq.gz,339286,56164,283122,0.8345,83.45
LSU-NL2_196_S1012_R2_001.fastq.gz,339286,131158,208128,0.6134,61.34
LSU-NL2_197_S1013_R1_001.fastq.gz,304523,44545,259978,0.8537,85.37
LSU-NL2_197_S1013_R2_001.fastq.gz,304523,103268,201255,0.6609,66.09
LSU-NL2_198_S1014_R1_001.fastq.gz,295920,62921,232999,0.7874,78.74
LSU-NL2_198_S1014_R2_001.fastq.gz,295920,128959,166961,0.5642,56.42
LSU-NL2_199_S1015_R1_001.fastq.gz,307444,46444,261000,0.8489,84.89
LSU-NL2_199_S1015_R2_001.fastq.gz,307444,115301,192143,0.6250,62.50
LSU-NL2_19_S979_R1_001.fastq.gz,270904,28648,242256,0.8943,89.43
LSU-NL2_19_S979_R2_001.fastq.gz,270904,73685,197219,0.7280,72.80
LSU-NL2_1_S961_R1_001.fastq.gz,310841,50627,260214,0.8371,83.71
LSU-NL2_1_S961_R2_001.fastq.gz,310841,115202,195639,0.6294,62.94
LSU-NL2_200_S1016_R1_001.fastq.gz,508796,73282,435514,0.8560,85.60
LSU-NL2_200_S1016_R2_001.fastq.gz,508796,196803,311993,0.6132,61.32
LSU-NL2_201_S1017_R1_001.fastq.gz,11761,6549,5212,0.4432,44.32
LSU-NL2_201_S1017_R2_001.fastq.gz,11761,8083,3678,0.3127,31.27
LSU-NL2_202_S1018_R1_001.fastq.gz,330978,34111,296867,0.8969,89.69
LSU-NL2_202_S1018_R2_001.fastq.gz,330978,95535,235443,0.7114,71.14
LSU-NL2_203_S1019_R1_001.fastq.gz,275291,39740,235551,0.8556,85.56
LSU-NL2_203_S1019_R2_001.fastq.gz,275291,98200,177091,0.6433,64.33
LSU-NL2_204_S1020_R1_001.fastq.gz,330301,43799,286502,0.8674,86.74
LSU-NL2_204_S1020_R2_001.fastq.gz,330301,100730,229571,0.6950,69.50
LSU-NL2_20_S980_R1_001.fastq.gz,333683,57972,275711,0.8263,82.63
LSU-NL2_20_S980_R2_001.fastq.gz,333683,134432,199251,0.5971,59.71
LSU-NL2_21_S981_R1_001.fastq.gz,336833,62648,274185,0.8140,81.40
LSU-NL2_21_S981_R2_001.fastq.gz,336833,132823,204010,0.6057,60.57
LSU-NL2_22_S982_R1_001.fastq.gz,312952,52031,260921,0.8337,83.37
LSU-NL2_22_S982_R2_001.fastq.gz,312952,111378,201574,0.6441,64.41
LSU-NL2_23_S983_R1_001.fastq.gz,16160,9314,6846,0.4236,42.36
LSU-NL2_23_S983_R2_001.fastq.gz,16160,11903,4257,0.2634,26.34
LSU-NL2_24_S984_R1_001.fastq.gz,418956,75272,343684,0.8203,82.03
LSU-NL2_24_S984_R2_001.fastq.gz,418956,173173,245783,0.5867,58.67
LSU-NL2_25_S985_R1_001.fastq.gz,248707,48355,200352,0.8056,80.56
LSU-NL2_25_S985_R2_001.fastq.gz,248707,103573,145134,0.5836,58.36
LSU-NL2_26_S986_R1_001.fastq.gz,241426,48697,192729,0.7983,79.83
LSU-NL2_26_S986_R2_001.fastq.gz,241426,103258,138168,0.5723,57.23
LSU-NL2_27_S987_R1_001.fastq.gz,231625,34892,196733,0.8494,84.94
LSU-NL2_27_S987_R2_001.fastq.gz,231625,86464,145161,0.6267,62.67
LSU-NL2_28_S988_R1_001.fastq.gz,306995,50402,256593,0.8358,83.58
LSU-NL2_28_S988_R2_001.fastq.gz,306995,122160,184835,0.6021,60.21
LSU-NL2_29_S989_R1_001.fastq.gz,237784,57787,179997,0.7570,75.70
LSU-NL2_29_S989_R2_001.fastq.gz,237784,112521,125263,0.5268,52.68
LSU-NL2_2_S962_R1_001.fastq.gz,348981,56007,292974,0.8395,83.95
LSU-NL2_2_S962_R2_001.fastq.gz,348981,128268,220713,0.6324,63.24
LSU-NL2_30_S990_R1_001.fastq.gz,363976,57686,306290,0.8415,84.15
LSU-NL2_30_S990_R2_001.fastq.gz,363976,138517,225459,0.6194,61.94
LSU-NL2_31_S991_R1_001.fastq.gz,322345,47639,274706,0.8522,85.22
LSU-NL2_31_S991_R2_001.fastq.gz,322345,121235,201110,0.6239,62.39
LSU-NL2_32_S992_R1_001.fastq.gz,373122,64869,308253,0.8261,82.61
LSU-NL2_32_S992_R2_001.fastq.gz,373122,146575,226547,0.6072,60.72
LSU-NL2_33_S993_R1_001.fastq.gz,342257,64301,277956,0.8121,81.21
LSU-NL2_33_S993_R2_001.fastq.gz,342257,135530,206727,0.6040,60.40
LSU-NL2_34_S994_R1_001.fastq.gz,334877,43571,291306,0.8699,86.99
LSU-NL2_34_S994_R2_001.fastq.gz,334877,100620,234257,0.6995,69.95
LSU-NL2_35_S995_R1_001.fastq.gz,280620,45629,234991,0.8374,83.74
LSU-NL2_35_S995_R2_001.fastq.gz,280620,106078,174542,0.6220,62.20
LSU-NL2_36_S996_R1_001.fastq.gz,340561,57427,283134,0.8314,83.14
LSU-NL2_36_S996_R2_001.fastq.gz,340561,128717,211844,0.6220,62.20
LSU-NL2_37_S997_R1_001.fastq.gz,359541,49266,310275,0.8630,86.30
LSU-NL2_37_S997_R2_001.fastq.gz,359541,117714,241827,0.6726,67.26
LSU-NL2_38_S998_R1_001.fastq.gz,300878,57811,243067,0.8079,80.79
LSU-NL2_38_S998_R2_001.fastq.gz,300878,120515,180363,0.5995,59.95
LSU-NL2_39_S999_R1_001.fastq.gz,343792,61788,282004,0.8203,82.03
LSU-NL2_39_S999_R2_001.fastq.gz,343792,143716,200076,0.5820,58.20
LSU-NL2_3_S963_R1_001.fastq.gz,250753,45235,205518,0.8196,81.96
LSU-NL2_3_S963_R2_001.fastq.gz,250753,97460,153293,0.6113,61.13
LSU-NL2_40_S1000_R1_001.fastq.gz,507918,87984,419934,0.8268,82.68
LSU-NL2_40_S1000_R2_001.fastq.gz,507918,198403,309515,0.6094,60.94
LSU-NL2_41_S1001_R1_001.fastq.gz,269460,51746,217714,0.8080,80.80
LSU-NL2_41_S1001_R2_001.fastq.gz,269460,93986,175474,0.6512,65.12
LSU-NL2_42_S1002_R1_001.fastq.gz,339632,57402,282230,0.8310,83.10
LSU-NL2_42_S1002_R2_001.fastq.gz,339632,118666,220966,0.6506,65.06
LSU-NL2_43_S1003_R1_001.fastq.gz,301049,67130,233919,0.7770,77.70
LSU-NL2_43_S1003_R2_001.fastq.gz,301049,116046,185003,0.6145,61.45
LSU-NL2_44_S1004_R1_001.fastq.gz,299551,30178,269373,0.8993,89.93
LSU-NL2_44_S1004_R2_001.fastq.gz,299551,74389,225162,0.7517,75.17
LSU-NL2_45_S1005_R1_001.fastq.gz,332880,57033,275847,0.8287,82.87
LSU-NL2_45_S1005_R2_001.fastq.gz,332880,113550,219330,0.6589,65.89
LSU-NL2_46_S1006_R1_001.fastq.gz,312513,80988,231525,0.7408,74.08
LSU-NL2_46_S1006_R2_001.fastq.gz,312513,141364,171149,0.5477,54.77
LSU-NL2_47_S1007_R1_001.fastq.gz,286888,65345,221543,0.7722,77.22
LSU-NL2_47_S1007_R2_001.fastq.gz,286888,121858,165030,0.5752,57.52
LSU-NL2_48_S1008_R1_001.fastq.gz,928392,156454,771938,0.8315,83.15
LSU-NL2_48_S1008_R2_001.fastq.gz,928392,329188,599204,0.6454,64.54
LSU-NL2_49_S1009_R1_001.fastq.gz,295961,41996,253965,0.8581,85.81
LSU-NL2_49_S1009_R2_001.fastq.gz,295961,98427,197534,0.6674,66.74
LSU-NL2_4_S964_R1_001.fastq.gz,312456,56526,255930,0.8191,81.91
LSU-NL2_4_S964_R2_001.fastq.gz,312456,119929,192527,0.6162,61.62
LSU-NL2_50_S1010_R1_001.fastq.gz,313531,61377,252154,0.8042,80.42
LSU-NL2_50_S1010_R2_001.fastq.gz,313531,130964,182567,0.5823,58.23
LSU-NL2_51_S1011_R1_001.fastq.gz,277122,49636,227486,0.8209,82.09
LSU-NL2_51_S1011_R2_001.fastq.gz,277122,115139,161983,0.5845,58.45
LSU-NL2_5_S965_R1_001.fastq.gz,367673,47744,319929,0.8701,87.01
LSU-NL2_5_S965_R2_001.fastq.gz,367673,123543,244130,0.6640,66.40
LSU-NL2_6_S966_R1_001.fastq.gz,303615,41422,262193,0.8636,86.36
LSU-NL2_6_S966_R2_001.fastq.gz,303615,95051,208564,0.6869,68.69
LSU-NL2_7_S967_R1_001.fastq.gz,330254,64498,265756,0.8047,80.47
LSU-NL2_7_S967_R2_001.fastq.gz,330254,147701,182553,0.5528,55.28
LSU-NL2_9_S969_R1_001.fastq.gz,185552,41014,144538,0.7790,77.90
LSU-NL2_9_S969_R2_001.fastq.gz,185552,84375,101177,0.5453,54.53
LSU-SB_100_S1380_R1_001.fastq.gz,333972,57531,276441,0.8277,82.77
LSU-SB_100_S1380_R2_001.fastq.gz,333972,106157,227815,0.6821,68.21
LSU-SB_101_S1381_R1_001.fastq.gz,390615,63325,327290,0.8379,83.79
LSU-SB_101_S1381_R2_001.fastq.gz,390615,116281,274334,0.7023,70.23
LSU-SB_102_S1382_R1_001.fastq.gz,297476,58992,238484,0.8017,80.17
LSU-SB_102_S1382_R2_001.fastq.gz,297476,102570,194906,0.6552,65.52
LSU-SB_103_S1383_R1_001.fastq.gz,484107,88384,395723,0.8174,81.74
LSU-SB_103_S1383_R2_001.fastq.gz,484107,161872,322235,0.6656,66.56
LSU-SB_104_S1384_R1_001.fastq.gz,45100,17726,27374,0.6070,60.70
LSU-SB_104_S1384_R2_001.fastq.gz,45100,24718,20382,0.4519,45.19
LSU-SB_105_S1385_R1_001.fastq.gz,365981,63529,302452,0.8264,82.64
LSU-SB_105_S1385_R2_001.fastq.gz,365981,113772,252209,0.6891,68.91
LSU-SB_106_S1386_R1_001.fastq.gz,336056,60422,275634,0.8202,82.02
LSU-SB_106_S1386_R2_001.fastq.gz,336056,101015,235041,0.6994,69.94
LSU-SB_107_S1387_R1_001.fastq.gz,414716,75186,339530,0.8187,81.87
LSU-SB_107_S1387_R2_001.fastq.gz,414716,128473,286243,0.6902,69.02
LSU-SB_108_S1388_R1_001.fastq.gz,410566,71777,338789,0.8252,82.52
LSU-SB_108_S1388_R2_001.fastq.gz,410566,126659,283907,0.6915,69.15
LSU-SB_109_S1389_R1_001.fastq.gz,464236,76268,387968,0.8357,83.57
LSU-SB_109_S1389_R2_001.fastq.gz,464236,132440,331796,0.7147,71.47
LSU-SB_110_S1390_R1_001.fastq.gz,297577,51092,246485,0.8283,82.83
LSU-SB_110_S1390_R2_001.fastq.gz,297577,89953,207624,0.6977,69.77
LSU-SB_111_S1391_R1_001.fastq.gz,425627,84673,340954,0.8011,80.11
LSU-SB_111_S1391_R2_001.fastq.gz,425627,141477,284150,0.6676,66.76
LSU-SB_112_S1392_R1_001.fastq.gz,412342,87412,324930,0.7880,78.80
LSU-SB_112_S1392_R2_001.fastq.gz,412342,144292,268050,0.6501,65.01
LSU-SB_113_S1393_R1_001.fastq.gz,402690,91189,311501,0.7736,77.36
LSU-SB_113_S1393_R2_001.fastq.gz,402690,133446,269244,0.6686,66.86
LSU-SB_114_S1394_R1_001.fastq.gz,298475,81961,216514,0.7254,72.54
LSU-SB_114_S1394_R2_001.fastq.gz,298475,107346,191129,0.6404,64.04
LSU-SB_115_S1395_R1_001.fastq.gz,18653,9826,8827,0.4732,47.32
LSU-SB_115_S1395_R2_001.fastq.gz,18653,12344,6309,0.3382,33.82
LSU-SB_117_S1397_R1_001.fastq.gz,425952,84824,341128,0.8009,80.09
LSU-SB_117_S1397_R2_001.fastq.gz,425952,121156,304796,0.7156,71.56
LSU-SB_118_S1398_R1_001.fastq.gz,325475,63789,261686,0.8040,80.40
LSU-SB_118_S1398_R2_001.fastq.gz,325475,91302,234173,0.7195,71.95
LSU-SB_119_S1399_R1_001.fastq.gz,617154,92746,524408,0.8497,84.97
LSU-SB_119_S1399_R2_001.fastq.gz,617154,147426,469728,0.7611,76.11
LSU-SB_120_S1400_R1_001.fastq.gz,507948,92335,415613,0.8182,81.82
LSU-SB_120_S1400_R2_001.fastq.gz,507948,136726,371222,0.7308,73.08
LSU-SB_121_S1401_R1_001.fastq.gz,384324,50287,334037,0.8692,86.92
LSU-SB_121_S1401_R2_001.fastq.gz,384324,96481,287843,0.7490,74.90
LSU-SB_122_S1402_R1_001.fastq.gz,11696,6082,5614,0.4800,48.00
LSU-SB_122_S1402_R2_001.fastq.gz,11696,7928,3768,0.3222,32.22
LSU-SB_123_S1403_R1_001.fastq.gz,349847,48896,300951,0.8602,86.02
LSU-SB_123_S1403_R2_001.fastq.gz,349847,90497,259350,0.7413,74.13
LSU-SB_124_S1404_R1_001.fastq.gz,436097,64543,371554,0.8520,85.20
LSU-SB_124_S1404_R2_001.fastq.gz,436097,116741,319356,0.7323,73.23
LSU-SB_125_S1405_R1_001.fastq.gz,348204,53636,294568,0.8460,84.60
LSU-SB_125_S1405_R2_001.fastq.gz,348204,98788,249416,0.7163,71.63
LSU-SB_126_S1406_R1_001.fastq.gz,284871,44739,240132,0.8429,84.29
LSU-SB_126_S1406_R2_001.fastq.gz,284871,84100,200771,0.7048,70.48
LSU-SB_127_S1407_R1_001.fastq.gz,461383,66878,394505,0.8550,85.50
LSU-SB_127_S1407_R2_001.fastq.gz,461383,133010,328373,0.7117,71.17
LSU-SB_128_S1408_R1_001.fastq.gz,561878,82076,479802,0.8539,85.39
LSU-SB_128_S1408_R2_001.fastq.gz,561878,152396,409482,0.7288,72.88
LSU-SB_129_S1409_R1_001.fastq.gz,13126,7090,6036,0.4599,45.99
LSU-SB_129_S1409_R2_001.fastq.gz,13126,9191,3935,0.2998,29.98
LSU-SB_12_S1036_R1_001.fastq.gz,337586,65093,272493,0.8072,80.72
LSU-SB_12_S1036_R2_001.fastq.gz,337586,144161,193425,0.5730,57.30
LSU-SB_130_S1410_R1_001.fastq.gz,343665,40847,302818,0.8811,88.11
LSU-SB_130_S1410_R2_001.fastq.gz,343665,78208,265457,0.7724,77.24
LSU-SB_131_S1411_R1_001.fastq.gz,370456,52630,317826,0.8579,85.79
LSU-SB_131_S1411_R2_001.fastq.gz,370456,94415,276041,0.7451,74.51
LSU-SB_132_S1412_R1_001.fastq.gz,376147,56235,319912,0.8505,85.05
LSU-SB_132_S1412_R2_001.fastq.gz,376147,97699,278448,0.7403,74.03
LSU-SB_133_S1413_R1_001.fastq.gz,341080,65276,275804,0.8086,80.86
LSU-SB_133_S1413_R2_001.fastq.gz,341080,110057,231023,0.6773,67.73
LSU-SB_134_S1414_R1_001.fastq.gz,283929,50288,233641,0.8229,82.29
LSU-SB_134_S1414_R2_001.fastq.gz,283929,82649,201280,0.7089,70.89
LSU-SB_136_S1416_R1_001.fastq.gz,19588,10444,9144,0.4668,46.68
LSU-SB_136_S1416_R2_001.fastq.gz,19588,13459,6129,0.3129,31.29
LSU-SB_137_S1417_R1_001.fastq.gz,349057,46174,302883,0.8677,86.77
LSU-SB_137_S1417_R2_001.fastq.gz,349057,85368,263689,0.7554,75.54
LSU-SB_138_S1418_R1_001.fastq.gz,361970,52501,309469,0.8550,85.50
LSU-SB_138_S1418_R2_001.fastq.gz,361970,92680,269290,0.7440,74.40
LSU-SB_139_S1419_R1_001.fastq.gz,391196,55049,336147,0.8593,85.93
LSU-SB_139_S1419_R2_001.fastq.gz,391196,97607,293589,0.7505,75.05
LSU-SB_13_S1037_R1_001.fastq.gz,423677,63604,360073,0.8499,84.99
LSU-SB_13_S1037_R2_001.fastq.gz,423677,136873,286804,0.6769,67.69
LSU-SB_140_S1420_R1_001.fastq.gz,485046,67476,417570,0.8609,86.09
LSU-SB_140_S1420_R2_001.fastq.gz,485046,118524,366522,0.7556,75.56
LSU-SB_141_S1421_R1_001.fastq.gz,472816,76220,396596,0.8388,83.88
LSU-SB_141_S1421_R2_001.fastq.gz,472816,136619,336197,0.7111,71.11
LSU-SB_142_S1422_R1_001.fastq.gz,400288,71275,329013,0.8219,82.19
LSU-SB_142_S1422_R2_001.fastq.gz,400288,122004,278284,0.6952,69.52
LSU-SB_143_S1423_R1_001.fastq.gz,499601,71749,427852,0.8564,85.64
LSU-SB_143_S1423_R2_001.fastq.gz,499601,135105,364496,0.7296,72.96
LSU-SB_144_S1424_R1_001.fastq.gz,569511,81652,487859,0.8566,85.66
LSU-SB_144_S1424_R2_001.fastq.gz,569511,151182,418329,0.7345,73.45
LSU-SB_145_S1426_R1_001.fastq.gz,370188,73319,296869,0.8019,80.19
LSU-SB_145_S1426_R2_001.fastq.gz,370188,132642,237546,0.6417,64.17
LSU-SB_147_S1427_R1_001.fastq.gz,312657,41008,271649,0.8688,86.88
LSU-SB_147_S1427_R2_001.fastq.gz,312657,83467,229190,0.7330,73.30
LSU-SB_148_S1428_R1_001.fastq.gz,460514,65394,395120,0.8580,85.80
LSU-SB_148_S1428_R2_001.fastq.gz,460514,136331,324183,0.7040,70.40
LSU-SB_149_S1429_R1_001.fastq.gz,328917,61719,267198,0.8124,81.24
LSU-SB_149_S1429_R2_001.fastq.gz,328917,117000,211917,0.6443,64.43
LSU-SB_14_S1038_R1_001.fastq.gz,299283,45005,254278,0.8496,84.96
LSU-SB_14_S1038_R2_001.fastq.gz,299283,94540,204743,0.6841,68.41
LSU-SB_150_S1430_R1_001.fastq.gz,15410,8392,7018,0.4554,45.54
LSU-SB_150_S1430_R2_001.fastq.gz,15410,11007,4403,0.2857,28.57
LSU-SB_151_S1431_R1_001.fastq.gz,491198,72093,419105,0.8532,85.32
LSU-SB_151_S1431_R2_001.fastq.gz,491198,142932,348266,0.7090,70.90
LSU-SB_152_S1432_R1_001.fastq.gz,471396,67879,403517,0.8560,85.60
LSU-SB_152_S1432_R2_001.fastq.gz,471396,131026,340370,0.7220,72.20
LSU-SB_153_S1433_R1_001.fastq.gz,365612,53160,312452,0.8546,85.46
LSU-SB_153_S1433_R2_001.fastq.gz,365612,98116,267496,0.7316,73.16
LSU-SB_154_S1434_R1_001.fastq.gz,395209,54794,340415,0.8614,86.14
LSU-SB_154_S1434_R2_001.fastq.gz,395209,98964,296245,0.7496,74.96
LSU-SB_155_S1435_R1_001.fastq.gz,226639,39796,186843,0.8244,82.44
LSU-SB_155_S1435_R2_001.fastq.gz,226639,67306,159333,0.7030,70.30
LSU-SB_156_S1436_R1_001.fastq.gz,263374,44088,219286,0.8326,83.26
LSU-SB_156_S1436_R2_001.fastq.gz,263374,76993,186381,0.7077,70.77
LSU-SB_158_S1438_R1_001.fastq.gz,404622,68683,335939,0.8303,83.03
LSU-SB_158_S1438_R2_001.fastq.gz,404622,117199,287423,0.7103,71.03
LSU-SB_159_S1439_R1_001.fastq.gz,579225,95234,483991,0.8356,83.56
LSU-SB_159_S1439_R2_001.fastq.gz,579225,175251,403974,0.6974,69.74
LSU-SB_15_S1039_R1_001.fastq.gz,408418,75787,332631,0.8144,81.44
LSU-SB_15_S1039_R2_001.fastq.gz,408418,163617,244801,0.5994,59.94
LSU-SB_161_S1023_R1_001.fastq.gz,12179,7076,5103,0.4190,41.90
LSU-SB_161_S1023_R2_001.fastq.gz,12179,8825,3354,0.2754,27.54
LSU-SB_162_S1024_R1_001.fastq.gz,380723,57931,322792,0.8478,84.78
LSU-SB_162_S1024_R2_001.fastq.gz,380723,133044,247679,0.6505,65.05
LSU-SB_17_S1041_R1_001.fastq.gz,291843,60510,231333,0.7927,79.27
LSU-SB_17_S1041_R2_001.fastq.gz,291843,123491,168352,0.5769,57.69
LSU-SB_18_S1042_R1_001.fastq.gz,286162,53353,232809,0.8136,81.36
LSU-SB_18_S1042_R2_001.fastq.gz,286162,127904,158258,0.5530,55.30
LSU-SB_19_S1043_R1_001.fastq.gz,276252,51576,224676,0.8133,81.33
LSU-SB_19_S1043_R2_001.fastq.gz,276252,113127,163125,0.5905,59.05
LSU-SB_1_S1025_R1_001.fastq.gz,306453,61344,245109,0.7998,79.98
LSU-SB_1_S1025_R2_001.fastq.gz,306453,131814,174639,0.5699,56.99
LSU-SB_21_S1045_R1_001.fastq.gz,344481,69097,275384,0.7994,79.94
LSU-SB_21_S1045_R2_001.fastq.gz,344481,152438,192043,0.5575,55.75
LSU-SB_22_S1046_R1_001.fastq.gz,324907,68800,256107,0.7882,78.82
LSU-SB_22_S1046_R2_001.fastq.gz,324907,142728,182179,0.5607,56.07
LSU-SB_23_S1047_R1_001.fastq.gz,340239,48274,291965,0.8581,85.81
LSU-SB_23_S1047_R2_001.fastq.gz,340239,121928,218311,0.6416,64.16
LSU-SB_24_S1048_R1_001.fastq.gz,401883,62494,339389,0.8445,84.45
LSU-SB_24_S1048_R2_001.fastq.gz,401883,155088,246795,0.6141,61.41
LSU-SB_25_S1049_R1_001.fastq.gz,287486,40734,246752,0.8583,85.83
LSU-SB_25_S1049_R2_001.fastq.gz,287486,98923,188563,0.6559,65.59
LSU-SB_26_S1050_R1_001.fastq.gz,325347,66365,258982,0.7960,79.60
LSU-SB_26_S1050_R2_001.fastq.gz,325347,134310,191037,0.5872,58.72
LSU-SB_27_S1051_R1_001.fastq.gz,318059,45240,272819,0.8578,85.78
LSU-SB_27_S1051_R2_001.fastq.gz,318059,109172,208887,0.6568,65.68
LSU-SB_28_S1052_R1_001.fastq.gz,356793,71336,285457,0.8001,80.01
LSU-SB_28_S1052_R2_001.fastq.gz,356793,156672,200121,0.5609,56.09
LSU-SB_29_S1053_R1_001.fastq.gz,294488,60733,233755,0.7938,79.38
LSU-SB_29_S1053_R2_001.fastq.gz,294488,132329,162159,0.5506,55.06
LSU-SB_2_S1026_R1_001.fastq.gz,277182,51653,225529,0.8136,81.36
LSU-SB_2_S1026_R2_001.fastq.gz,277182,109895,167287,0.6035,60.35
LSU-SB_30_S1054_R1_001.fastq.gz,319096,53282,265814,0.8330,83.30
LSU-SB_30_S1054_R2_001.fastq.gz,319096,119659,199437,0.6250,62.50
LSU-SB_31_S1055_R1_001.fastq.gz,15325,8869,6456,0.4213,42.13
LSU-SB_31_S1055_R2_001.fastq.gz,15325,11305,4020,0.2623,26.23
LSU-SB_3_S1027_R1_001.fastq.gz,258504,47690,210814,0.8155,81.55
LSU-SB_3_S1027_R2_001.fastq.gz,258504,103671,154833,0.5990,59.90
LSU-SB_4_S1028_R1_001.fastq.gz,291336,66830,224506,0.7706,77.06
LSU-SB_4_S1028_R2_001.fastq.gz,291336,134986,156350,0.5367,53.67
LSU-SB_5_S1029_R1_001.fastq.gz,324642,52133,272509,0.8394,83.94
LSU-SB_5_S1029_R2_001.fastq.gz,324642,118653,205989,0.6345,63.45
LSU-SB_65_S1345_R1_001.fastq.gz,252081,29297,222784,0.8838,88.38
LSU-SB_65_S1345_R2_001.fastq.gz,252081,65390,186691,0.7406,74.06
LSU-SB_66_S1346_R1_001.fastq.gz,307182,41496,265686,0.8649,86.49
LSU-SB_66_S1346_R2_001.fastq.gz,307182,77156,230026,0.7488,74.88
LSU-SB_67_S1347_R1_001.fastq.gz,364538,45646,318892,0.8748,87.48
LSU-SB_67_S1347_R2_001.fastq.gz,364538,90156,274382,0.7527,75.27
LSU-SB_69_S1349_R1_001.fastq.gz,24818,11925,12893,0.5195,51.95
LSU-SB_69_S1349_R2_001.fastq.gz,24818,16514,8304,0.3346,33.46
LSU-SB_6_S1030_R1_001.fastq.gz,298715,53686,245029,0.8203,82.03
LSU-SB_6_S1030_R2_001.fastq.gz,298715,112564,186151,0.6232,62.32
LSU-SB_70_S1350_R1_001.fastq.gz,449747,52469,397278,0.8833,88.33
LSU-SB_70_S1350_R2_001.fastq.gz,449747,104117,345630,0.7685,76.85
LSU-SB_71_S1351_R1_001.fastq.gz,391758,60885,330873,0.8446,84.46
LSU-SB_71_S1351_R2_001.fastq.gz,391758,110495,281263,0.7180,71.80
LSU-SB_72_S1352_R1_001.fastq.gz,515958,84299,431659,0.8366,83.66
LSU-SB_72_S1352_R2_001.fastq.gz,515958,149344,366614,0.7106,71.06
LSU-SB_74_S1354_R1_001.fastq.gz,325949,52528,273421,0.8388,83.88
LSU-SB_74_S1354_R2_001.fastq.gz,325949,93456,232493,0.7133,71.33
LSU-SB_75_S1355_R1_001.fastq.gz,311968,56566,255402,0.8187,81.87
LSU-SB_75_S1355_R2_001.fastq.gz,311968,105845,206123,0.6607,66.07
LSU-SB_76_S1356_R1_001.fastq.gz,415451,73177,342274,0.8239,82.39
LSU-SB_76_S1356_R2_001.fastq.gz,415451,126724,288727,0.6950,69.50
LSU-SB_77_S1357_R1_001.fastq.gz,418630,78620,340010,0.8122,81.22
LSU-SB_77_S1357_R2_001.fastq.gz,418630,142424,276206,0.6598,65.98
LSU-SB_78_S1358_R1_001.fastq.gz,565242,101669,463573,0.8201,82.01
LSU-SB_78_S1358_R2_001.fastq.gz,565242,184295,380947,0.6740,67.40
LSU-SB_7_S1031_R1_001.fastq.gz,360523,62963,297560,0.8254,82.54
LSU-SB_7_S1031_R2_001.fastq.gz,360523,138615,221908,0.6155,61.55
LSU-SB_80_S1360_R1_001.fastq.gz,565769,106248,459521,0.8122,81.22
LSU-SB_80_S1360_R2_001.fastq.gz,565769,182213,383556,0.6779,67.79
LSU-SB_81_S1361_R1_001.fastq.gz,364477,57091,307386,0.8434,84.34
LSU-SB_81_S1361_R2_001.fastq.gz,364477,105252,259225,0.7112,71.12
LSU-SB_82_S1362_R1_001.fastq.gz,16071,8525,7546,0.4695,46.95
LSU-SB_82_S1362_R2_001.fastq.gz,16071,11271,4800,0.2987,29.87
LSU-SB_83_S1363_R1_001.fastq.gz,325921,65723,260198,0.7983,79.83
LSU-SB_83_S1363_R2_001.fastq.gz,325921,114859,211062,0.6476,64.76
LSU-SB_86_S1366_R1_001.fastq.gz,452419,79381,373038,0.8245,82.45
LSU-SB_86_S1366_R2_001.fastq.gz,452419,136317,316102,0.6987,69.87
LSU-SB_87_S1367_R1_001.fastq.gz,399116,76168,322948,0.8092,80.92
LSU-SB_87_S1367_R2_001.fastq.gz,399116,134657,264459,0.6626,66.26
LSU-SB_89_S1369_R1_001.fastq.gz,12924,7183,5741,0.4442,44.42
LSU-SB_89_S1369_R2_001.fastq.gz,12924,9525,3399,0.2630,26.30
LSU-SB_8_S1032_R1_001.fastq.gz,263087,53099,209988,0.7982,79.82
LSU-SB_8_S1032_R2_001.fastq.gz,263087,106795,156292,0.5941,59.41
LSU-SB_90_S1370_R1_001.fastq.gz,217645,41329,176316,0.8101,81.01
LSU-SB_90_S1370_R2_001.fastq.gz,217645,72657,144988,0.6662,66.62
LSU-SB_91_S1371_R1_001.fastq.gz,334232,56705,277527,0.8303,83.03
LSU-SB_91_S1371_R2_001.fastq.gz,334232,106719,227513,0.6807,68.07
LSU-SB_92_S1372_R1_001.fastq.gz,319207,49661,269546,0.8444,84.44
LSU-SB_92_S1372_R2_001.fastq.gz,319207,94746,224461,0.7032,70.32
LSU-SB_93_S1373_R1_001.fastq.gz,15710,8529,7181,0.4571,45.71
LSU-SB_93_S1373_R2_001.fastq.gz,15710,11387,4323,0.2752,27.52
LSU-SB_94_S1374_R1_001.fastq.gz,381094,66526,314568,0.8254,82.54
LSU-SB_94_S1374_R2_001.fastq.gz,381094,126944,254150,0.6669,66.69
LSU-SB_96_S1376_R1_001.fastq.gz,329834,56297,273537,0.8293,82.93
LSU-SB_96_S1376_R2_001.fastq.gz,329834,100679,229155,0.6948,69.48
LSU-SB_97_S1377_R1_001.fastq.gz,380669,70134,310535,0.8158,81.58
LSU-SB_97_S1377_R2_001.fastq.gz,380669,132688,247981,0.6514,65.14
LSU-SB_98_S1378_R1_001.fastq.gz,295037,58797,236240,0.8007,80.07
LSU-SB_98_S1378_R2_001.fastq.gz,295037,105959,189078,0.6409,64.09
LSU-SB_99_S1379_R1_001.fastq.gz,375960,73413,302547,0.8047,80.47
LSU-SB_99_S1379_R2_001.fastq.gz,375960,131430,244530,0.6504,65.04
LSU-SB_9_S1033_R1_001.fastq.gz,339269,43947,295322,0.8705,87.05
LSU-SB_9_S1033_R2_001.fastq.gz,339269,98275,240994,0.7103,71.03
SSU-Blank1_S384_R1_001.fastq.gz,23791,10234,13557,0.5698,56.98
SSU-Blank1_S384_R2_001.fastq.gz,23791,16782,7009,0.2946,29.46
SSU-Blank2_S960_R1_001.fastq.gz,22147,12411,9736,0.4396,43.96
SSU-Blank2_S960_R2_001.fastq.gz,22147,16293,5854,0.2643,26.43
SSU-Blank3_S1536_R1_001.fastq.gz,57208,15746,41462,0.7248,72.48
SSU-Blank3_S1536_R2_001.fastq.gz,57208,27503,29705,0.5192,51.92
SSU-NL2_102_S290_R1_001.fastq.gz,379452,51951,327501,0.8631,86.31
SSU-NL2_102_S290_R2_001.fastq.gz,379452,102040,277412,0.7311,73.11
SSU-NL2_103_S291_R1_001.fastq.gz,519189,68359,450830,0.8683,86.83
SSU-NL2_103_S291_R2_001.fastq.gz,519189,123772,395417,0.7616,76.16
SSU-NL2_104_S292_R1_001.fastq.gz,379503,56166,323337,0.8520,85.20
SSU-NL2_104_S292_R2_001.fastq.gz,379503,104535,274968,0.7245,72.45
SSU-NL2_105_S293_R1_001.fastq.gz,450623,54628,395995,0.8788,87.88
SSU-NL2_105_S293_R2_001.fastq.gz,450623,109934,340689,0.7560,75.60
SSU-NL2_106_S294_R1_001.fastq.gz,369234,46860,322374,0.8731,87.31
SSU-NL2_106_S294_R2_001.fastq.gz,369234,88812,280422,0.7595,75.95
SSU-NL2_107_S295_R1_001.fastq.gz,489351,74098,415253,0.8486,84.86
SSU-NL2_107_S295_R2_001.fastq.gz,489351,140607,348744,0.7127,71.27
SSU-NL2_108_S296_R1_001.fastq.gz,541632,82142,459490,0.8483,84.83
SSU-NL2_108_S296_R2_001.fastq.gz,541632,170490,371142,0.6852,68.52
SSU-NL2_109_S297_R1_001.fastq.gz,277049,33067,243982,0.8806,88.06
SSU-NL2_109_S297_R2_001.fastq.gz,277049,70526,206523,0.7454,74.54
SSU-NL2_10_S874_R1_001.fastq.gz,330684,52501,278183,0.8412,84.12
SSU-NL2_10_S874_R2_001.fastq.gz,330684,92067,238617,0.7216,72.16
SSU-NL2_110_S298_R1_001.fastq.gz,14055,7058,6997,0.4978,49.78
SSU-NL2_110_S298_R2_001.fastq.gz,14055,9515,4540,0.3230,32.30
SSU-NL2_111_S299_R1_001.fastq.gz,392834,29647,363187,0.9245,92.45
SSU-NL2_111_S299_R2_001.fastq.gz,392834,65886,326948,0.8323,83.23
SSU-NL2_112_S300_R1_001.fastq.gz,364181,39738,324443,0.8909,89.09
SSU-NL2_112_S300_R2_001.fastq.gz,364181,88440,275741,0.7572,75.72
SSU-NL2_113_S301_R1_001.fastq.gz,441158,57970,383188,0.8686,86.86
SSU-NL2_113_S301_R2_001.fastq.gz,441158,118821,322337,0.7307,73.07
SSU-NL2_117_S305_R1_001.fastq.gz,371193,48442,322751,0.8695,86.95
SSU-NL2_117_S305_R2_001.fastq.gz,371193,109108,262085,0.7061,70.61
SSU-NL2_118_S306_R1_001.fastq.gz,8118,4266,3852,0.4745,47.45
SSU-NL2_118_S306_R2_001.fastq.gz,8118,5936,2182,0.2688,26.88
SSU-NL2_119_S307_R1_001.fastq.gz,242355,36489,205866,0.8494,84.94
SSU-NL2_119_S307_R2_001.fastq.gz,242355,69949,172406,0.7114,71.14
SSU-NL2_11_S875_R1_001.fastq.gz,10450,6129,4321,0.4135,41.35
SSU-NL2_11_S875_R2_001.fastq.gz,10450,7468,2982,0.2854,28.54
SSU-NL2_120_S308_R1_001.fastq.gz,9084,5061,4023,0.4429,44.29
SSU-NL2_120_S308_R2_001.fastq.gz,9084,6647,2437,0.2683,26.83
SSU-NL2_121_S309_R1_001.fastq.gz,296839,20904,275935,0.9296,92.96
SSU-NL2_121_S309_R2_001.fastq.gz,296839,54957,241882,0.8149,81.49
SSU-NL2_122_S310_R1_001.fastq.gz,315609,39674,275935,0.8743,87.43
SSU-NL2_122_S310_R2_001.fastq.gz,315609,87845,227764,0.7217,72.17
SSU-NL2_123_S311_R1_001.fastq.gz,8887,4636,4251,0.4783,47.83
SSU-NL2_123_S311_R2_001.fastq.gz,8887,6337,2550,0.2869,28.69
SSU-NL2_124_S312_R1_001.fastq.gz,322546,39466,283080,0.8776,87.76
SSU-NL2_124_S312_R2_001.fastq.gz,322546,92359,230187,0.7137,71.37
SSU-NL2_125_S313_R1_001.fastq.gz,329900,36957,292943,0.8880,88.80
SSU-NL2_125_S313_R2_001.fastq.gz,329900,77649,252251,0.7646,76.46
SSU-NL2_126_S314_R1_001.fastq.gz,10159,5294,4865,0.4789,47.89
SSU-NL2_126_S314_R2_001.fastq.gz,10159,6798,3361,0.3308,33.08
SSU-NL2_127_S315_R1_001.fastq.gz,10922,5804,5118,0.4686,46.86
SSU-NL2_127_S315_R2_001.fastq.gz,10922,7187,3735,0.3420,34.20
SSU-NL2_12_S876_R1_001.fastq.gz,386362,57260,329102,0.8518,85.18
SSU-NL2_12_S876_R2_001.fastq.gz,386362,97049,289313,0.7488,74.88
SSU-NL2_131_S319_R1_001.fastq.gz,10969,5643,5326,0.4856,48.56
SSU-NL2_131_S319_R2_001.fastq.gz,10969,7293,3676,0.3351,33.51
SSU-NL2_132_S320_R1_001.fastq.gz,508211,43771,464440,0.9139,91.39
SSU-NL2_132_S320_R2_001.fastq.gz,508211,106335,401876,0.7908,79.08
SSU-NL2_133_S321_R1_001.fastq.gz,366580,57409,309171,0.8434,84.34
SSU-NL2_133_S321_R2_001.fastq.gz,366580,105781,260799,0.7114,71.14
SSU-NL2_135_S323_R1_001.fastq.gz,11897,6124,5773,0.4852,48.52
SSU-NL2_135_S323_R2_001.fastq.gz,11897,7930,3967,0.3334,33.34
SSU-NL2_136_S324_R1_001.fastq.gz,11938,6386,5552,0.4651,46.51
SSU-NL2_136_S324_R2_001.fastq.gz,11938,8236,3702,0.3101,31.01
SSU-NL2_137a_S325_R1_001.fastq.gz,456227,59691,396536,0.8692,86.92
SSU-NL2_137a_S325_R2_001.fastq.gz,456227,115244,340983,0.7474,74.74
SSU-NL2_137b_S326_R1_001.fastq.gz,14242,7363,6879,0.4830,48.30
SSU-NL2_137b_S326_R2_001.fastq.gz,14242,9700,4542,0.3189,31.89
SSU-NL2_138_S925_R1_001.fastq.gz,245321,28675,216646,0.8831,88.31
SSU-NL2_138_S925_R2_001.fastq.gz,245321,51120,194201,0.7916,79.16
SSU-NL2_13_S885_R1_001.fastq.gz,14890,8028,6862,0.4608,46.08
SSU-NL2_13_S885_R2_001.fastq.gz,14890,10286,4604,0.3092,30.92
SSU-NL2_140_S328_R1_001.fastq.gz,591199,61771,529428,0.8955,89.55
SSU-NL2_140_S328_R2_001.fastq.gz,591199,153968,437231,0.7396,73.96
SSU-NL2_142_S330_R1_001.fastq.gz,316459,30825,285634,0.9026,90.26
SSU-NL2_142_S330_R2_001.fastq.gz,316459,67675,248784,0.7861,78.61
SSU-NL2_143_S331_R1_001.fastq.gz,12380,6531,5849,0.4725,47.25
SSU-NL2_143_S331_R2_001.fastq.gz,12380,8280,4100,0.3312,33.12
SSU-NL2_144_S332_R1_001.fastq.gz,216646,31054,185592,0.8567,85.67
SSU-NL2_144_S332_R2_001.fastq.gz,216646,55924,160722,0.7419,74.19
SSU-NL2_146_S334_R1_001.fastq.gz,291594,36287,255307,0.8756,87.56
SSU-NL2_146_S334_R2_001.fastq.gz,291594,67497,224097,0.7685,76.85
SSU-NL2_147_S335_R1_001.fastq.gz,317345,24631,292714,0.9224,92.24
SSU-NL2_147_S335_R2_001.fastq.gz,317345,58304,259041,0.8163,81.63
SSU-NL2_148_S336_R1_001.fastq.gz,528091,70034,458057,0.8674,86.74
SSU-NL2_148_S336_R2_001.fastq.gz,528091,150836,377255,0.7144,71.44
SSU-NL2_149_S337_R1_001.fastq.gz,57037,9644,47393,0.8309,83.09
SSU-NL2_149_S337_R2_001.fastq.gz,57037,16536,40501,0.7101,71.01
SSU-NL2_14_S878_R1_001.fastq.gz,13366,7681,5685,0.4253,42.53
SSU-NL2_14_S878_R2_001.fastq.gz,13366,9387,3979,0.2977,29.77
SSU-NL2_150_S338_R1_001.fastq.gz,346437,23883,322554,0.9311,93.11
SSU-NL2_150_S338_R2_001.fastq.gz,346437,62974,283463,0.8182,81.82
SSU-NL2_151_S339_R1_001.fastq.gz,346457,39090,307367,0.8872,88.72
SSU-NL2_151_S339_R2_001.fastq.gz,346457,73300,273157,0.7884,78.84
SSU-NL2_152_S340_R1_001.fastq.gz,435787,55944,379843,0.8716,87.16
SSU-NL2_152_S340_R2_001.fastq.gz,435787,111308,324479,0.7446,74.46
SSU-NL2_153_S341_R1_001.fastq.gz,412047,59235,352812,0.8562,85.62
SSU-NL2_153_S341_R2_001.fastq.gz,412047,112876,299171,0.7261,72.61
SSU-NL2_155_S343_R1_001.fastq.gz,11759,6037,5722,0.4866,48.66
SSU-NL2_155_S343_R2_001.fastq.gz,11759,7964,3795,0.3227,32.27
SSU-NL2_158_S346_R1_001.fastq.gz,435951,54883,381068,0.8741,87.41
SSU-NL2_158_S346_R2_001.fastq.gz,435951,114311,321640,0.7378,73.78
SSU-NL2_15_S879_R1_001.fastq.gz,11803,7077,4726,0.4004,40.04
SSU-NL2_15_S879_R2_001.fastq.gz,11803,8644,3159,0.2676,26.76
SSU-NL2_160_S348_R1_001.fastq.gz,301693,40420,261273,0.8660,86.60
SSU-NL2_160_S348_R2_001.fastq.gz,301693,78163,223530,0.7409,74.09
SSU-NL2_161_S349_R1_001.fastq.gz,8613,4622,3991,0.4634,46.34
SSU-NL2_161_S349_R2_001.fastq.gz,8613,5750,2863,0.3324,33.24
SSU-NL2_162_S350_R1_001.fastq.gz,13356,6352,7004,0.5244,52.44
SSU-NL2_162_S350_R2_001.fastq.gz,13356,8222,5134,0.3844,38.44
SSU-NL2_163_S351_R1_001.fastq.gz,424569,41595,382974,0.9020,90.20
SSU-NL2_163_S351_R2_001.fastq.gz,424569,88755,335814,0.7910,79.10
SSU-NL2_164_S352_R1_001.fastq.gz,473873,74915,398958,0.8419,84.19
SSU-NL2_164_S352_R2_001.fastq.gz,473873,152897,320976,0.6773,67.73
SSU-NL2_166_S354_R1_001.fastq.gz,291511,31999,259512,0.8902,89.02
SSU-NL2_166_S354_R2_001.fastq.gz,291511,68865,222646,0.7638,76.38
SSU-NL2_167_S355_R1_001.fastq.gz,304678,27656,277022,0.9092,90.92
SSU-NL2_167_S355_R2_001.fastq.gz,304678,63908,240770,0.7902,79.02
SSU-NL2_168_S356_R1_001.fastq.gz,9321,5087,4234,0.4542,45.42
SSU-NL2_168_S356_R2_001.fastq.gz,9321,6528,2793,0.2996,29.96
SSU-NL2_169_S357_R1_001.fastq.gz,8325,4430,3895,0.4679,46.79
SSU-NL2_169_S357_R2_001.fastq.gz,8325,5719,2606,0.3130,31.30
SSU-NL2_16_S880_R1_001.fastq.gz,596658,92154,504504,0.8455,84.55
SSU-NL2_16_S880_R2_001.fastq.gz,596658,168185,428473,0.7181,71.81
SSU-NL2_170_S358_R1_001.fastq.gz,226513,32217,194296,0.8578,85.78
SSU-NL2_170_S358_R2_001.fastq.gz,226513,59010,167503,0.7395,73.95
SSU-NL2_171_S359_R1_001.fastq.gz,462139,40465,421674,0.9124,91.24
SSU-NL2_171_S359_R2_001.fastq.gz,462139,93582,368557,0.7975,79.75
SSU-NL2_172_S360_R1_001.fastq.gz,289506,30725,258781,0.8939,89.39
SSU-NL2_172_S360_R2_001.fastq.gz,289506,71841,217665,0.7518,75.18
SSU-NL2_173_S361_R1_001.fastq.gz,339116,25358,313758,0.9252,92.52
SSU-NL2_173_S361_R2_001.fastq.gz,339116,62622,276494,0.8153,81.53
SSU-NL2_177_S365_R1_001.fastq.gz,291862,40784,251078,0.8603,86.03
SSU-NL2_177_S365_R2_001.fastq.gz,291862,75049,216813,0.7429,74.29
SSU-NL2_178_S366_R1_001.fastq.gz,272123,23820,248303,0.9125,91.25
SSU-NL2_178_S366_R2_001.fastq.gz,272123,49929,222194,0.8165,81.65
SSU-NL2_17_S881_R1_001.fastq.gz,339894,75820,264074,0.7769,77.69
SSU-NL2_17_S881_R2_001.fastq.gz,339894,114763,225131,0.6624,66.24
SSU-NL2_180_S368_R1_001.fastq.gz,410161,33242,376919,0.9190,91.90
SSU-NL2_180_S368_R2_001.fastq.gz,410161,84490,325671,0.7940,79.40
SSU-NL2_181_S369_R1_001.fastq.gz,289444,32234,257210,0.8886,88.86
SSU-NL2_181_S369_R2_001.fastq.gz,289444,74632,214812,0.7422,74.22
SSU-NL2_182_S370_R1_001.fastq.gz,433913,73083,360830,0.8316,83.16
SSU-NL2_182_S370_R2_001.fastq.gz,433913,150935,282978,0.6522,65.22
SSU-NL2_183_S371_R1_001.fastq.gz,278809,31494,247315,0.8870,88.70
SSU-NL2_183_S371_R2_001.fastq.gz,278809,66209,212600,0.7625,76.25
SSU-NL2_184_S372_R1_001.fastq.gz,336653,32930,303723,0.9022,90.22
SSU-NL2_184_S372_R2_001.fastq.gz,336653,75679,260974,0.7752,77.52
SSU-NL2_185_S373_R1_001.fastq.gz,10900,5706,5194,0.4765,47.65
SSU-NL2_185_S373_R2_001.fastq.gz,10900,7490,3410,0.3128,31.28
SSU-NL2_187_S375_R1_001.fastq.gz,470263,57619,412644,0.8775,87.75
SSU-NL2_187_S375_R2_001.fastq.gz,470263,129834,340429,0.7239,72.39
SSU-NL2_188_S376_R1_001.fastq.gz,488792,46030,442762,0.9058,90.58
SSU-NL2_188_S376_R2_001.fastq.gz,488792,120467,368325,0.7535,75.35
SSU-NL2_189_S377_R1_001.fastq.gz,316351,39331,277020,0.8757,87.57
SSU-NL2_189_S377_R2_001.fastq.gz,316351,85056,231295,0.7311,73.11
SSU-NL2_18_S882_R1_001.fastq.gz,381004,54146,326858,0.8579,85.79
SSU-NL2_18_S882_R2_001.fastq.gz,381004,100073,280931,0.7373,73.73
SSU-NL2_190_S378_R1_001.fastq.gz,317098,34331,282767,0.8917,89.17
SSU-NL2_190_S378_R2_001.fastq.gz,317098,76076,241022,0.7601,76.01
SSU-NL2_191_S379_R1_001.fastq.gz,481455,56504,424951,0.8826,88.26
SSU-NL2_191_S379_R2_001.fastq.gz,481455,111996,369459,0.7674,76.74
SSU-NL2_192_S380_R1_001.fastq.gz,361430,56231,305199,0.8444,84.44
SSU-NL2_192_S380_R2_001.fastq.gz,361430,104876,256554,0.7098,70.98
SSU-NL2_193_S381_R1_001.fastq.gz,545962,72842,473120,0.8666,86.66
SSU-NL2_193_S381_R2_001.fastq.gz,545962,135554,410408,0.7517,75.17
SSU-NL2_194_S382_R1_001.fastq.gz,479865,60044,419821,0.8749,87.49
SSU-NL2_194_S382_R2_001.fastq.gz,479865,128987,350878,0.7312,73.12
SSU-NL2_195_S383_R1_001.fastq.gz,414601,60159,354442,0.8549,85.49
SSU-NL2_195_S383_R2_001.fastq.gz,414601,111465,303136,0.7312,73.12
SSU-NL2_196_S916_R1_001.fastq.gz,421091,62385,358706,0.8518,85.18
SSU-NL2_196_S916_R2_001.fastq.gz,421091,117853,303238,0.7201,72.01
SSU-NL2_197_S917_R1_001.fastq.gz,395632,68956,326676,0.8257,82.57
SSU-NL2_197_S917_R2_001.fastq.gz,395632,120591,275041,0.6952,69.52
SSU-NL2_198_S918_R1_001.fastq.gz,347420,52686,294734,0.8484,84.84
SSU-NL2_198_S918_R2_001.fastq.gz,347420,93959,253461,0.7296,72.96
SSU-NL2_199_S919_R1_001.fastq.gz,404705,67689,337016,0.8327,83.27
SSU-NL2_199_S919_R2_001.fastq.gz,404705,130049,274656,0.6787,67.87
SSU-NL2_19_S883_R1_001.fastq.gz,10494,6028,4466,0.4256,42.56
SSU-NL2_19_S883_R2_001.fastq.gz,10494,7538,2956,0.2817,28.17
SSU-NL2_1_S865_R1_001.fastq.gz,366686,64237,302449,0.8248,82.48
SSU-NL2_1_S865_R2_001.fastq.gz,366686,115355,251331,0.6854,68.54
SSU-NL2_200_S920_R1_001.fastq.gz,493252,78259,414993,0.8413,84.13
SSU-NL2_200_S920_R2_001.fastq.gz,493252,142382,350870,0.7113,71.13
SSU-NL2_201_S921_R1_001.fastq.gz,12476,7104,5372,0.4306,43.06
SSU-NL2_201_S921_R2_001.fastq.gz,12476,8834,3642,0.2919,29.19
SSU-NL2_202_S922_R1_001.fastq.gz,402452,49629,352823,0.8767,87.67
SSU-NL2_202_S922_R2_001.fastq.gz,402452,100691,301761,0.7498,74.98
SSU-NL2_203_S923_R1_001.fastq.gz,375814,49584,326230,0.8681,86.81
SSU-NL2_203_S923_R2_001.fastq.gz,375814,90165,285649,0.7601,76.01
SSU-NL2_204_S924_R1_001.fastq.gz,387198,52863,334335,0.8635,86.35
SSU-NL2_204_S924_R2_001.fastq.gz,387198,91296,295902,0.7642,76.42
SSU-NL2_20_S884_R1_001.fastq.gz,360418,63566,296852,0.8236,82.36
SSU-NL2_20_S884_R2_001.fastq.gz,360418,109821,250597,0.6953,69.53
SSU-NL2_21_S877_R1_001.fastq.gz,737618,105395,632223,0.8571,85.71
SSU-NL2_21_S877_R2_001.fastq.gz,737618,181110,556508,0.7545,75.45
SSU-NL2_22_S886_R1_001.fastq.gz,293166,53438,239728,0.8177,81.77
SSU-NL2_22_S886_R2_001.fastq.gz,293166,89367,203799,0.6952,69.52
SSU-NL2_23_S887_R1_001.fastq.gz,11636,6762,4874,0.4189,41.89
SSU-NL2_23_S887_R2_001.fastq.gz,11636,8628,3008,0.2585,25.85
SSU-NL2_24_S888_R1_001.fastq.gz,574955,95377,479578,0.8341,83.41
SSU-NL2_24_S888_R2_001.fastq.gz,574955,171590,403365,0.7016,70.16
SSU-NL2_25_S889_R1_001.fastq.gz,352704,71814,280890,0.7964,79.64
SSU-NL2_25_S889_R2_001.fastq.gz,352704,115906,236798,0.6714,67.14
SSU-NL2_28_S892_R1_001.fastq.gz,408122,66006,342116,0.8383,83.83
SSU-NL2_28_S892_R2_001.fastq.gz,408122,118762,289360,0.7090,70.90
SSU-NL2_29_S893_R1_001.fastq.gz,318804,56451,262353,0.8229,82.29
SSU-NL2_29_S893_R2_001.fastq.gz,318804,96756,222048,0.6965,69.65
SSU-NL2_2_S866_R1_001.fastq.gz,287034,46516,240518,0.8379,83.79
SSU-NL2_2_S866_R2_001.fastq.gz,287034,87774,199260,0.6942,69.42
SSU-NL2_30_S894_R1_001.fastq.gz,348631,54067,294564,0.8449,84.49
SSU-NL2_30_S894_R2_001.fastq.gz,348631,95983,252648,0.7247,72.47
SSU-NL2_31_S895_R1_001.fastq.gz,390285,55663,334622,0.8574,85.74
SSU-NL2_31_S895_R2_001.fastq.gz,390285,108254,282031,0.7226,72.26
SSU-NL2_32_S896_R1_001.fastq.gz,20954,11792,9162,0.4372,43.72
SSU-NL2_32_S896_R2_001.fastq.gz,20954,14980,5974,0.2851,28.51
SSU-NL2_33_S897_R1_001.fastq.gz,423605,62667,360938,0.8521,85.21
SSU-NL2_33_S897_R2_001.fastq.gz,423605,112789,310816,0.7337,73.37
SSU-NL2_34_S898_R1_001.fastq.gz,359860,59640,300220,0.8343,83.43
SSU-NL2_34_S898_R2_001.fastq.gz,359860,113219,246641,0.6854,68.54
SSU-NL2_35_S899_R1_001.fastq.gz,295302,45563,249739,0.8457,84.57
SSU-NL2_35_S899_R2_001.fastq.gz,295302,77832,217470,0.7364,73.64
SSU-NL2_36_S900_R1_001.fastq.gz,401604,66196,335408,0.8352,83.52
SSU-NL2_36_S900_R2_001.fastq.gz,401604,117414,284190,0.7076,70.76
SSU-NL2_37_S901_R1_001.fastq.gz,409770,68324,341446,0.8333,83.33
SSU-NL2_37_S901_R2_001.fastq.gz,409770,123281,286489,0.6991,69.91
SSU-NL2_38_S902_R1_001.fastq.gz,297140,50733,246407,0.8293,82.93
SSU-NL2_38_S902_R2_001.fastq.gz,297140,86985,210155,0.7073,70.73
SSU-NL2_39_S903_R1_001.fastq.gz,364430,63086,301344,0.8269,82.69
SSU-NL2_39_S903_R2_001.fastq.gz,364430,113242,251188,0.6893,68.93
SSU-NL2_3_S867_R1_001.fastq.gz,308960,47182,261778,0.8473,84.73
SSU-NL2_3_S867_R2_001.fastq.gz,308960,84631,224329,0.7261,72.61
SSU-NL2_40_S904_R1_001.fastq.gz,557370,81645,475725,0.8535,85.35
SSU-NL2_40_S904_R2_001.fastq.gz,557370,150516,406854,0.7300,73.00
SSU-NL2_41_S905_R1_001.fastq.gz,284265,45642,238623,0.8394,83.94
SSU-NL2_41_S905_R2_001.fastq.gz,284265,78132,206133,0.7251,72.51
SSU-NL2_42_S906_R1_001.fastq.gz,386550,70762,315788,0.8169,81.69
SSU-NL2_42_S906_R2_001.fastq.gz,386550,116486,270064,0.6987,69.87
SSU-NL2_43_S907_R1_001.fastq.gz,315388,42678,272710,0.8647,86.47
SSU-NL2_43_S907_R2_001.fastq.gz,315388,80453,234935,0.7449,74.49
SSU-NL2_44_S908_R1_001.fastq.gz,366287,59585,306702,0.8373,83.73
SSU-NL2_44_S908_R2_001.fastq.gz,366287,103058,263229,0.7186,71.86
SSU-NL2_45_S909_R1_001.fastq.gz,404148,62512,341636,0.8453,84.53
SSU-NL2_45_S909_R2_001.fastq.gz,404148,107543,296605,0.7339,73.39
SSU-NL2_46_S910_R1_001.fastq.gz,355462,53056,302406,0.8507,85.07
SSU-NL2_46_S910_R2_001.fastq.gz,355462,94199,261263,0.7350,73.50
SSU-NL2_47_S911_R1_001.fastq.gz,420581,72762,347819,0.8270,82.70
SSU-NL2_47_S911_R2_001.fastq.gz,420581,127778,292803,0.6962,69.62
SSU-NL2_48_S912_R1_001.fastq.gz,587445,78225,509220,0.8668,86.68
SSU-NL2_48_S912_R2_001.fastq.gz,587445,145459,441986,0.7524,75.24
SSU-NL2_49_S913_R1_001.fastq.gz,303983,41475,262508,0.8636,86.36
SSU-NL2_49_S913_R2_001.fastq.gz,303983,75301,228682,0.7523,75.23
SSU-NL2_4_S868_R1_001.fastq.gz,418191,85975,332216,0.7944,79.44
SSU-NL2_4_S868_R2_001.fastq.gz,418191,145382,272809,0.6524,65.24
SSU-NL2_50_S914_R1_001.fastq.gz,365441,64521,300920,0.8234,82.34
SSU-NL2_50_S914_R2_001.fastq.gz,365441,115415,250026,0.6842,68.42
SSU-NL2_51_S915_R1_001.fastq.gz,347881,47674,300207,0.8630,86.30
SSU-NL2_51_S915_R2_001.fastq.gz,347881,85277,262604,0.7549,75.49
SSU-NL2_5_S869_R1_001.fastq.gz,326150,41809,284341,0.8718,87.18
SSU-NL2_5_S869_R2_001.fastq.gz,326150,77977,248173,0.7609,76.09
SSU-NL2_6_S870_R1_001.fastq.gz,568591,104288,464303,0.8166,81.66
SSU-NL2_6_S870_R2_001.fastq.gz,568591,182490,386101,0.6790,67.90
SSU-NL2_7_S871_R1_001.fastq.gz,368768,51485,317283,0.8604,86.04
SSU-NL2_7_S871_R2_001.fastq.gz,368768,100346,268422,0.7279,72.79
SSU-NL2_9_S873_R1_001.fastq.gz,271348,41833,229515,0.8458,84.58
SSU-NL2_9_S873_R2_001.fastq.gz,271348,69329,202019,0.7445,74.45
SSU-SB_100_S1476_R1_001.fastq.gz,328785,55742,273043,0.8305,83.05
SSU-SB_100_S1476_R2_001.fastq.gz,328785,118446,210339,0.6397,63.97
SSU-SB_101_S1477_R1_001.fastq.gz,316391,36477,279914,0.8847,88.47
SSU-SB_101_S1477_R2_001.fastq.gz,316391,90140,226251,0.7151,71.51
SSU-SB_102_S1478_R1_001.fastq.gz,282788,32292,250496,0.8858,88.58
SSU-SB_102_S1478_R2_001.fastq.gz,282788,78797,203991,0.7214,72.14
SSU-SB_103_S1479_R1_001.fastq.gz,308818,53953,254865,0.8253,82.53
SSU-SB_103_S1479_R2_001.fastq.gz,308818,115734,193084,0.6252,62.52
SSU-SB_104_S1480_R1_001.fastq.gz,566162,84531,481631,0.8507,85.07
SSU-SB_104_S1480_R2_001.fastq.gz,566162,194625,371537,0.6562,65.62
SSU-SB_105_S1481_R1_001.fastq.gz,238591,30385,208206,0.8726,87.26
SSU-SB_105_S1481_R2_001.fastq.gz,238591,68759,169832,0.7118,71.18
SSU-SB_106_S1482_R1_001.fastq.gz,285063,43251,241812,0.8483,84.83
SSU-SB_106_S1482_R2_001.fastq.gz,285063,104738,180325,0.6326,63.26
SSU-SB_107_S1483_R1_001.fastq.gz,167912,23910,144002,0.8576,85.76
SSU-SB_107_S1483_R2_001.fastq.gz,167912,56277,111635,0.6648,66.48
SSU-SB_108_S1484_R1_001.fastq.gz,340356,35711,304645,0.8951,89.51
SSU-SB_108_S1484_R2_001.fastq.gz,340356,92599,247757,0.7279,72.79
SSU-SB_109_S1485_R1_001.fastq.gz,357865,63865,294000,0.8215,82.15
SSU-SB_109_S1485_R2_001.fastq.gz,357865,129565,228300,0.6380,63.80
SSU-SB_110_S1486_R1_001.fastq.gz,360389,58173,302216,0.8386,83.86
SSU-SB_110_S1486_R2_001.fastq.gz,360389,124306,236083,0.6551,65.51
SSU-SB_111_S1487_R1_001.fastq.gz,303607,58959,244648,0.8058,80.58
SSU-SB_111_S1487_R2_001.fastq.gz,303607,127105,176502,0.5814,58.14
SSU-SB_112_S1488_R1_001.fastq.gz,436236,74795,361441,0.8285,82.85
SSU-SB_112_S1488_R2_001.fastq.gz,436236,171589,264647,0.6067,60.67
SSU-SB_114_S1490_R1_001.fastq.gz,304038,51236,252802,0.8315,83.15
SSU-SB_114_S1490_R2_001.fastq.gz,304038,111280,192758,0.6340,63.40
SSU-SB_115_S1491_R1_001.fastq.gz,17545,8648,8897,0.5071,50.71
SSU-SB_115_S1491_R2_001.fastq.gz,17545,12156,5389,0.3072,30.72
SSU-SB_117_S1493_R1_001.fastq.gz,260055,41107,218948,0.8419,84.19
SSU-SB_117_S1493_R2_001.fastq.gz,260055,91529,168526,0.6480,64.80
SSU-SB_118_S1494_R1_001.fastq.gz,294480,33886,260594,0.8849,88.49
SSU-SB_118_S1494_R2_001.fastq.gz,294480,84700,209780,0.7124,71.24
SSU-SB_119_S1495_R1_001.fastq.gz,446982,36134,410848,0.9192,91.92
SSU-SB_119_S1495_R2_001.fastq.gz,446982,101855,345127,0.7721,77.21
SSU-SB_120_S1496_R1_001.fastq.gz,365828,40103,325725,0.8904,89.04
SSU-SB_120_S1496_R2_001.fastq.gz,365828,98865,266963,0.7298,72.98
SSU-SB_121_S1497_R1_001.fastq.gz,304664,47191,257473,0.8451,84.51
SSU-SB_121_S1497_R2_001.fastq.gz,304664,107626,197038,0.6467,64.67
SSU-SB_122_S1498_R1_001.fastq.gz,11210,6013,5197,0.4636,46.36
SSU-SB_122_S1498_R2_001.fastq.gz,11210,7890,3320,0.2962,29.62
SSU-SB_123_S1499_R1_001.fastq.gz,206969,41713,165256,0.7985,79.85
SSU-SB_123_S1499_R2_001.fastq.gz,206969,83067,123902,0.5987,59.87
SSU-SB_124_S1500_R1_001.fastq.gz,259380,39616,219764,0.8473,84.73
SSU-SB_124_S1500_R2_001.fastq.gz,259380,80842,178538,0.6883,68.83
SSU-SB_125_S1501_R1_001.fastq.gz,326417,51915,274502,0.8410,84.10
SSU-SB_125_S1501_R2_001.fastq.gz,326417,114095,212322,0.6505,65.05
SSU-SB_126_S1502_R1_001.fastq.gz,257688,48924,208764,0.8101,81.01
SSU-SB_126_S1502_R2_001.fastq.gz,257688,95926,161762,0.6277,62.77
SSU-SB_127_S1503_R1_001.fastq.gz,341177,51427,289750,0.8493,84.93
SSU-SB_127_S1503_R2_001.fastq.gz,341177,108012,233165,0.6834,68.34
SSU-SB_128_S1504_R1_001.fastq.gz,334036,36210,297826,0.8916,89.16
SSU-SB_128_S1504_R2_001.fastq.gz,334036,78331,255705,0.7655,76.55
SSU-SB_129_S1505_R1_001.fastq.gz,12123,6223,5900,0.4867,48.67
SSU-SB_129_S1505_R2_001.fastq.gz,12123,8483,3640,0.3003,30.03
SSU-SB_12_S940_R1_001.fastq.gz,364314,61999,302315,0.8298,82.98
SSU-SB_12_S940_R2_001.fastq.gz,364314,87775,276539,0.7591,75.91
SSU-SB_130_S1506_R1_001.fastq.gz,10868,5616,5252,0.4833,48.33
SSU-SB_130_S1506_R2_001.fastq.gz,10868,7594,3274,0.3013,30.13
SSU-SB_131_S1507_R1_001.fastq.gz,321601,62250,259351,0.8064,80.64
SSU-SB_131_S1507_R2_001.fastq.gz,321601,135201,186400,0.5796,57.96
SSU-SB_132_S1508_R1_001.fastq.gz,338718,43078,295640,0.8728,87.28
SSU-SB_132_S1508_R2_001.fastq.gz,338718,104843,233875,0.6905,69.05
SSU-SB_133_S1509_R1_001.fastq.gz,334779,57392,277387,0.8286,82.86
SSU-SB_133_S1509_R2_001.fastq.gz,334779,125122,209657,0.6263,62.63
SSU-SB_134_S1510_R1_001.fastq.gz,278284,53642,224642,0.8072,80.72
SSU-SB_134_S1510_R2_001.fastq.gz,278284,106219,172065,0.6183,61.83
SSU-SB_136_S1512_R1_001.fastq.gz,16918,8554,8364,0.4944,49.44
SSU-SB_136_S1512_R2_001.fastq.gz,16918,11383,5535,0.3272,32.72
SSU-SB_137_S1513_R1_001.fastq.gz,354912,55824,299088,0.8427,84.27
SSU-SB_137_S1513_R2_001.fastq.gz,354912,123486,231426,0.6521,65.21
SSU-SB_138_S1514_R1_001.fastq.gz,290907,34961,255946,0.8798,87.98
SSU-SB_138_S1514_R2_001.fastq.gz,290907,82498,208409,0.7164,71.64
SSU-SB_139_S1515_R1_001.fastq.gz,301107,48133,252974,0.8401,84.01
SSU-SB_139_S1515_R2_001.fastq.gz,301107,102259,198848,0.6604,66.04
SSU-SB_13_S941_R1_001.fastq.gz,374493,71382,303111,0.8094,80.94
SSU-SB_13_S941_R2_001.fastq.gz,374493,104272,270221,0.7216,72.16
SSU-SB_140_S1516_R1_001.fastq.gz,310915,47142,263773,0.8484,84.84
SSU-SB_140_S1516_R2_001.fastq.gz,310915,99140,211775,0.6811,68.11
SSU-SB_141_S1517_R1_001.fastq.gz,250049,31154,218895,0.8754,87.54
SSU-SB_141_S1517_R2_001.fastq.gz,250049,71051,178998,0.7159,71.59
SSU-SB_142_S1518_R1_001.fastq.gz,297567,36955,260612,0.8758,87.58
SSU-SB_142_S1518_R2_001.fastq.gz,297567,84941,212626,0.7145,71.45
SSU-SB_143_S1519_R1_001.fastq.gz,532728,102421,430307,0.8077,80.77
SSU-SB_143_S1519_R2_001.fastq.gz,532728,207587,325141,0.6103,61.03
SSU-SB_144_S1520_R1_001.fastq.gz,337102,40330,296772,0.8804,88.04
SSU-SB_144_S1520_R2_001.fastq.gz,337102,89553,247549,0.7343,73.43
SSU-SB_145_S1522_R1_001.fastq.gz,264924,58732,206192,0.7783,77.83
SSU-SB_145_S1522_R2_001.fastq.gz,264924,120106,144818,0.5466,54.66
SSU-SB_147_S1523_R1_001.fastq.gz,308631,38568,270063,0.8750,87.50
SSU-SB_147_S1523_R2_001.fastq.gz,308631,97284,211347,0.6848,68.48
SSU-SB_148_S1524_R1_001.fastq.gz,214498,31767,182731,0.8519,85.19
SSU-SB_148_S1524_R2_001.fastq.gz,214498,71623,142875,0.6661,66.61
SSU-SB_149_S1525_R1_001.fastq.gz,313006,51501,261505,0.8355,83.55
SSU-SB_149_S1525_R2_001.fastq.gz,313006,117039,195967,0.6261,62.61
SSU-SB_14_S942_R1_001.fastq.gz,397915,75335,322580,0.8107,81.07
SSU-SB_14_S942_R2_001.fastq.gz,397915,111335,286580,0.7202,72.02
SSU-SB_150_S1526_R1_001.fastq.gz,17379,8709,8670,0.4989,49.89
SSU-SB_150_S1526_R2_001.fastq.gz,17379,11915,5464,0.3144,31.44
SSU-SB_151_S1527_R1_001.fastq.gz,382214,56975,325239,0.8509,85.09
SSU-SB_151_S1527_R2_001.fastq.gz,382214,133569,248645,0.6505,65.05
SSU-SB_152_S1528_R1_001.fastq.gz,361605,67757,293848,0.8126,81.26
SSU-SB_152_S1528_R2_001.fastq.gz,361605,146219,215386,0.5956,59.56
SSU-SB_153_S1529_R1_001.fastq.gz,146148,23293,122855,0.8406,84.06
SSU-SB_153_S1529_R2_001.fastq.gz,146148,50914,95234,0.6516,65.16
SSU-SB_154_S1530_R1_001.fastq.gz,11369,6059,5310,0.4671,46.71
SSU-SB_154_S1530_R2_001.fastq.gz,11369,7926,3443,0.3028,30.28
SSU-SB_155_S1531_R1_001.fastq.gz,269242,43843,225399,0.8372,83.72
SSU-SB_155_S1531_R2_001.fastq.gz,269242,94372,174870,0.6495,64.95
SSU-SB_156_S1532_R1_001.fastq.gz,262125,46484,215641,0.8227,82.27
SSU-SB_156_S1532_R2_001.fastq.gz,262125,94044,168081,0.6412,64.12
SSU-SB_158_S1534_R1_001.fastq.gz,142825,26361,116464,0.8154,81.54
SSU-SB_158_S1534_R2_001.fastq.gz,142825,51611,91214,0.6386,63.86
SSU-SB_159_S1535_R1_001.fastq.gz,436712,64112,372600,0.8532,85.32
SSU-SB_159_S1535_R2_001.fastq.gz,436712,135642,301070,0.6894,68.94
SSU-SB_15_S943_R1_001.fastq.gz,459703,102573,357130,0.7769,77.69
SSU-SB_15_S943_R2_001.fastq.gz,459703,147698,312005,0.6787,67.87
SSU-SB_161_S927_R1_001.fastq.gz,13493,7787,5706,0.4229,42.29
SSU-SB_161_S927_R2_001.fastq.gz,13493,9809,3684,0.2730,27.30
SSU-SB_162_S928_R1_001.fastq.gz,359043,55521,303522,0.8454,84.54
SSU-SB_162_S928_R2_001.fastq.gz,359043,90327,268716,0.7484,74.84
SSU-SB_17_S945_R1_001.fastq.gz,407886,67874,340012,0.8336,83.36
SSU-SB_17_S945_R2_001.fastq.gz,407886,114300,293586,0.7198,71.98
SSU-SB_18_S946_R1_001.fastq.gz,391405,55815,335590,0.8574,85.74
SSU-SB_18_S946_R2_001.fastq.gz,391405,100359,291046,0.7436,74.36
SSU-SB_19_S947_R1_001.fastq.gz,337953,57303,280650,0.8304,83.04
SSU-SB_19_S947_R2_001.fastq.gz,337953,100462,237491,0.7027,70.27
SSU-SB_1_S929_R1_001.fastq.gz,338858,91347,247511,0.7304,73.04
SSU-SB_1_S929_R2_001.fastq.gz,338858,103714,235144,0.6939,69.39
SSU-SB_21_S949_R1_001.fastq.gz,391600,60614,330986,0.8452,84.52
SSU-SB_21_S949_R2_001.fastq.gz,391600,105477,286123,0.7307,73.07
SSU-SB_22_S950_R1_001.fastq.gz,477754,85382,392372,0.8213,82.13
SSU-SB_22_S950_R2_001.fastq.gz,477754,146369,331385,0.6936,69.36
SSU-SB_23_S951_R1_001.fastq.gz,684303,114495,569808,0.8327,83.27
SSU-SB_23_S951_R2_001.fastq.gz,684303,220134,464169,0.6783,67.83
SSU-SB_24_S952_R1_001.fastq.gz,486582,80475,406107,0.8346,83.46
SSU-SB_24_S952_R2_001.fastq.gz,486582,150625,335957,0.6904,69.04
SSU-SB_25_S953_R1_001.fastq.gz,301477,44501,256976,0.8524,85.24
SSU-SB_25_S953_R2_001.fastq.gz,301477,79463,222014,0.7364,73.64
SSU-SB_26_S954_R1_001.fastq.gz,424192,73849,350343,0.8259,82.59
SSU-SB_26_S954_R2_001.fastq.gz,424192,134416,289776,0.6831,68.31
SSU-SB_27_S955_R1_001.fastq.gz,349597,71140,278457,0.7965,79.65
SSU-SB_27_S955_R2_001.fastq.gz,349597,118570,231027,0.6608,66.08
SSU-SB_28_S956_R1_001.fastq.gz,295769,58574,237195,0.8020,80.20
SSU-SB_28_S956_R2_001.fastq.gz,295769,101955,193814,0.6553,65.53
SSU-SB_29_S957_R1_001.fastq.gz,380203,65888,314315,0.8267,82.67
SSU-SB_29_S957_R2_001.fastq.gz,380203,112381,267822,0.7044,70.44
SSU-SB_2_S930_R1_001.fastq.gz,369823,97765,272058,0.7356,73.56
SSU-SB_2_S930_R2_001.fastq.gz,369823,111881,257942,0.6975,69.75
SSU-SB_30_S958_R1_001.fastq.gz,441403,67381,374022,0.8473,84.73
SSU-SB_30_S958_R2_001.fastq.gz,441403,121989,319414,0.7236,72.36
SSU-SB_31_S959_R1_001.fastq.gz,15889,9088,6801,0.4280,42.80
SSU-SB_31_S959_R2_001.fastq.gz,15889,11818,4071,0.2562,25.62
SSU-SB_3_S931_R1_001.fastq.gz,273739,77893,195846,0.7154,71.54
SSU-SB_3_S931_R2_001.fastq.gz,273739,85565,188174,0.6874,68.74
SSU-SB_4_S932_R1_001.fastq.gz,431866,114447,317419,0.7350,73.50
SSU-SB_4_S932_R2_001.fastq.gz,431866,138820,293046,0.6786,67.86
SSU-SB_5_S933_R1_001.fastq.gz,459576,119304,340272,0.7404,74.04
SSU-SB_5_S933_R2_001.fastq.gz,459576,142682,316894,0.6895,68.95
SSU-SB_65_S1441_R1_001.fastq.gz,170526,21488,149038,0.8740,87.40
SSU-SB_65_S1441_R2_001.fastq.gz,170526,43601,126925,0.7443,74.43
SSU-SB_66_S1442_R1_001.fastq.gz,278408,63616,214792,0.7715,77.15
SSU-SB_66_S1442_R2_001.fastq.gz,278408,143563,134845,0.4843,48.43
SSU-SB_67_S1443_R1_001.fastq.gz,300897,46444,254453,0.8456,84.56
SSU-SB_67_S1443_R2_001.fastq.gz,300897,103549,197348,0.6559,65.59
SSU-SB_69_S1445_R1_001.fastq.gz,360975,32003,328972,0.9113,91.13
SSU-SB_69_S1445_R2_001.fastq.gz,360975,84391,276584,0.7662,76.62
SSU-SB_6_S934_R1_001.fastq.gz,378336,93492,284844,0.7529,75.29
SSU-SB_6_S934_R2_001.fastq.gz,378336,108954,269382,0.7120,71.20
SSU-SB_70_S1446_R1_001.fastq.gz,295051,37002,258049,0.8746,87.46
SSU-SB_70_S1446_R2_001.fastq.gz,295051,91194,203857,0.6909,69.09
SSU-SB_71_S1447_R1_001.fastq.gz,352627,39418,313209,0.8882,88.82
SSU-SB_71_S1447_R2_001.fastq.gz,352627,95730,256897,0.7285,72.85
SSU-SB_72_S1448_R1_001.fastq.gz,422330,76144,346186,0.8197,81.97
SSU-SB_72_S1448_R2_001.fastq.gz,422330,160443,261887,0.6201,62.01
SSU-SB_74_S1450_R1_001.fastq.gz,200525,26067,174458,0.8700,87.00
SSU-SB_74_S1450_R2_001.fastq.gz,200525,62923,137602,0.6862,68.62
SSU-SB_75_S1451_R1_001.fastq.gz,269690,33576,236114,0.8755,87.55
SSU-SB_75_S1451_R2_001.fastq.gz,269690,79487,190203,0.7053,70.53
SSU-SB_76_S1452_R1_001.fastq.gz,337624,50545,287079,0.8503,85.03
SSU-SB_76_S1452_R2_001.fastq.gz,337624,112811,224813,0.6659,66.59
SSU-SB_77_S1453_R1_001.fastq.gz,318929,38798,280131,0.8783,87.83
SSU-SB_77_S1453_R2_001.fastq.gz,318929,88351,230578,0.7230,72.30
SSU-SB_78_S1454_R1_001.fastq.gz,331121,33205,297916,0.8997,89.97
SSU-SB_78_S1454_R2_001.fastq.gz,331121,79094,252027,0.7611,76.11
SSU-SB_7_S935_R1_001.fastq.gz,606351,153183,453168,0.7474,74.74
SSU-SB_7_S935_R2_001.fastq.gz,606351,194317,412034,0.6795,67.95
SSU-SB_80_S1456_R1_001.fastq.gz,482450,42477,439973,0.9120,91.20
SSU-SB_80_S1456_R2_001.fastq.gz,482450,122927,359523,0.7452,74.52
SSU-SB_81_S1457_R1_001.fastq.gz,256042,24975,231067,0.9025,90.25
SSU-SB_81_S1457_R2_001.fastq.gz,256042,79722,176320,0.6886,68.86
SSU-SB_82_S1458_R1_001.fastq.gz,10896,5684,5212,0.4783,47.83
SSU-SB_82_S1458_R2_001.fastq.gz,10896,8032,2864,0.2628,26.28
SSU-SB_83_S1459_R1_001.fastq.gz,248600,36352,212248,0.8538,85.38
SSU-SB_83_S1459_R2_001.fastq.gz,248600,95000,153600,0.6179,61.79
SSU-SB_85_S1461_R1_001.fastq.gz,251891,20849,231042,0.9172,91.72
SSU-SB_85_S1461_R2_001.fastq.gz,251891,70498,181393,0.7201,72.01
SSU-SB_86_S1462_R1_001.fastq.gz,199681,22694,176987,0.8863,88.63
SSU-SB_86_S1462_R2_001.fastq.gz,199681,65917,133764,0.6699,66.99
SSU-SB_87_S1463_R1_001.fastq.gz,340141,49001,291140,0.8559,85.59
SSU-SB_87_S1463_R2_001.fastq.gz,340141,121968,218173,0.6414,64.14
SSU-SB_88_S1464_R1_001.fastq.gz,445779,45433,400346,0.8981,89.81
SSU-SB_88_S1464_R2_001.fastq.gz,445779,120764,325015,0.7291,72.91
SSU-SB_89_S1465_R1_001.fastq.gz,14001,7175,6826,0.4875,48.75
SSU-SB_89_S1465_R2_001.fastq.gz,14001,9525,4476,0.3197,31.97
SSU-SB_8_S936_R1_001.fastq.gz,355763,100849,254914,0.7165,71.65
SSU-SB_8_S936_R2_001.fastq.gz,355763,112829,242934,0.6829,68.29
SSU-SB_90_S1466_R1_001.fastq.gz,236308,38514,197794,0.8370,83.70
SSU-SB_90_S1466_R2_001.fastq.gz,236308,90720,145588,0.6161,61.61
SSU-SB_91_S1467_R1_001.fastq.gz,277516,31703,245813,0.8858,88.58
SSU-SB_91_S1467_R2_001.fastq.gz,277516,71277,206239,0.7432,74.32
SSU-SB_92_S1468_R1_001.fastq.gz,304998,50390,254608,0.8348,83.48
SSU-SB_92_S1468_R2_001.fastq.gz,304998,112142,192856,0.6323,63.23
SSU-SB_93_S1469_R1_001.fastq.gz,16939,8615,8324,0.4914,49.14
SSU-SB_93_S1469_R2_001.fastq.gz,16939,11602,5337,0.3151,31.51
SSU-SB_94_S1470_R1_001.fastq.gz,338650,54979,283671,0.8377,83.77
SSU-SB_94_S1470_R2_001.fastq.gz,338650,121408,217242,0.6415,64.15
SSU-SB_96_S1472_R1_001.fastq.gz,513573,73251,440322,0.8574,85.74
SSU-SB_96_S1472_R2_001.fastq.gz,513573,158542,355031,0.6913,69.13
SSU-SB_97_S1473_R1_001.fastq.gz,402087,60518,341569,0.8495,84.95
SSU-SB_97_S1473_R2_001.fastq.gz,402087,141275,260812,0.6486,64.86
SSU-SB_98_S1474_R1_001.fastq.gz,325608,41579,284029,0.8723,87.23
SSU-SB_98_S1474_R2_001.fastq.gz,325608,104755,220853,0.6783,67.83
SSU-SB_99_S1475_R1_001.fastq.gz,239577,30682,208895,0.8719,87.19
SSU-SB_99_S1475_R2_001.fastq.gz,239577,75568,164009,0.6846,68.46
SSU-SB_9_S937_R1_001.fastq.gz,385236,70052,315184,0.8182,81.82
SSU-SB_9_S937_R2_001.fastq.gz,385236,98066,287170,0.7454,74.54
Undetermined_S0_R1_001.fastq.gz,138205247,24084986,114120261,0.8257,82.57
Undetermined_S0_R2_001.fastq.gz,138205247,48541360,89663887,0.6488,64.88
